"","fish_id","bin","LLLL","LLLR","LLRL","LLRR","LRLL","LRLR","LRRL","LRRR","RLLL","RLLR","RLRL","RLRR","RRLL","RRLR","RRRL","RRRR","L","R","total_turns","reps","alts","rel_reps","rel_alts","rel_R","rel_L"
"1","1","1",0,1,5,3,3,7,9,8,1,7,4,15,5,12,8,12,37,66,103,12,11,11.6504854368932,10.6796116504854,64.0776699029126,35.9223300970874
"2","1","2",1,2,0,3,0,2,1,4,2,1,2,2,3,2,3,32,13,50,63,33,4,52.3809523809524,6.34920634920635,79.3650793650794,20.6349206349206
"3","1","3",0,0,0,2,0,2,3,6,0,2,2,7,2,8,7,45,14,75,89,45,4,50.561797752809,4.49438202247191,84.2696629213483,15.7303370786517
"4","1","4",0,2,5,3,5,75,9,9,2,6,74,16,3,15,9,9,109,136,245,9,149,3.6734693877551,60.8163265306122,55.5102040816327,44.4897959183673
"5","1","5",0,1,2,1,2,33,4,9,1,3,33,12,2,11,9,8,54,80,134,8,66,5.97014925373134,49.2537313432836,59.7014925373134,40.2985074626866
"6","1","6",0,0,0,1,0,59,3,15,0,1,59,17,1,17,15,12,78,125,203,12,118,5.91133004926108,58.128078817734,61.576354679803,38.423645320197
"7","10","1",38,11,8,4,7,5,4,4,10,1,4,4,5,3,4,1,83,33,116,39,9,33.6206896551724,7.75862068965517,28.448275862069,71.551724137931
"8","10","2",1,5,4,6,5,17,8,8,5,5,18,9,5,10,8,10,55,72,127,11,35,8.66141732283465,27.5590551181102,56.6929133858268,43.3070866141732
"9","10","3",1,2,3,4,2,10,3,11,2,5,8,10,5,8,10,17,36,68,104,18,18,17.3076923076923,17.3076923076923,65.3846153846154,34.6153846153846
"10","10","4",3,4,4,5,1,4,3,11,4,5,1,9,7,6,10,11,35,56,91,14,5,15.3846153846154,5.49450549450549,61.5384615384615,38.4615384615385
"11","10","5",4,2,2,5,2,7,5,6,2,5,6,6,5,5,6,2,34,39,73,6,13,8.21917808219178,17.8082191780822,53.4246575342466,46.5753424657534
"12","10","6",1,2,1,2,0,3,2,5,2,1,2,5,4,3,5,14,18,37,55,15,5,27.2727272727273,9.09090909090909,67.2727272727273,32.7272727272727
"13","11","1",5,8,10,9,14,19,9,4,8,12,23,4,6,7,4,1,80,66,146,6,42,4.10958904109589,28.7671232876712,45.2054794520548,54.7945205479452
"14","11","2",15,7,10,5,11,8,11,0,7,9,9,6,5,7,1,0,69,45,114,15,17,13.1578947368421,14.9122807017544,39.4736842105263,60.5263157894737
"15","11","3",14,7,4,8,3,6,9,3,7,5,5,3,9,2,3,2,55,38,93,16,11,17.2043010752688,11.8279569892473,40.8602150537634,59.1397849462366
"16","11","4",1,7,9,2,7,13,5,3,7,4,10,6,4,4,3,1,48,41,89,2,23,2.24719101123596,25.8426966292135,46.0674157303371,53.9325842696629
"17","11","5",0,3,3,1,3,9,1,3,3,1,10,3,0,4,3,0,25,25,50,0,19,0,38,50,50
"18","11","6",0,0,1,2,0,26,5,1,0,2,26,4,2,4,1,0,37,40,77,0,52,0,67.5324675324675,51.9480519480519,48.0519480519481
"19","12","1",3,2,3,7,2,7,6,11,3,8,6,10,9,9,11,32,44,88,132,35,13,26.5151515151515,9.84848484848485,66.6666666666667,33.3333333333333
"20","12","2",0,0,0,2,0,3,0,10,0,2,3,8,2,8,10,44,15,80,95,44,6,46.3157894736842,6.31578947368421,84.2105263157895,15.7894736842105
"21","12","3",0,0,0,0,0,3,0,5,0,0,3,6,0,6,6,26,9,49,58,26,6,44.8275862068966,10.3448275862069,84.4827586206897,15.5172413793103
"22","12","4",0,0,0,1,0,1,0,3,0,1,1,2,1,2,3,22,5,35,40,22,2,55,5,87.5,12.5
"23","12","5",0,0,0,1,0,0,1,2,0,1,0,2,1,2,2,18,4,29,33,18,0,54.5454545454545,0,87.8787878787879,12.1212121212121
"24","12","6",0,0,0,0,0,2,0,1,0,0,2,1,0,1,1,8,3,16,19,8,4,42.1052631578947,21.0526315789474,84.2105263157895,15.7894736842105
"25","13","1",1,2,2,0,1,1,0,0,1,0,1,0,0,0,0,0,9,3,12,1,2,8.33333333333333,16.6666666666667,25,75
"26","13","2",0,0,0,0,0,3,0,2,0,0,3,2,0,2,2,10,6,21,27,10,6,37.037037037037,22.2222222222222,77.7777777777778,22.2222222222222
"27","13","3",0,0,0,3,2,2,3,3,0,3,4,3,1,6,4,4,14,27,41,4,6,9.75609756097561,14.6341463414634,65.8536585365854,34.1463414634146
"28","13","4",2,1,3,0,3,7,0,1,1,3,7,1,1,1,2,1,19,18,37,3,14,8.10810810810811,37.8378378378378,48.6486486486486,51.3513513513514
"29","13","5",3,2,1,4,5,1,3,2,2,3,5,1,1,4,2,3,23,22,45,6,6,13.3333333333333,13.3333333333333,48.8888888888889,51.1111111111111
"30","13","6",0,0,1,0,2,23,3,3,0,2,24,6,0,6,3,2,34,44,78,2,47,2.56410256410256,60.2564102564103,56.4102564102564,43.5897435897436
"31","14","1",2,2,2,3,5,3,4,0,2,3,5,1,0,3,0,0,22,16,38,2,8,5.26315789473684,21.0526315789474,42.1052631578947,57.8947368421053
"32","14","2",1,2,1,3,1,0,0,8,2,2,1,5,3,6,8,41,18,69,87,42,1,48.2758620689655,1.14942528735632,79.3103448275862,20.6896551724138
"33","14","3",0,1,1,2,1,4,2,9,1,2,4,9,2,9,8,24,20,62,82,24,8,29.2682926829268,9.75609756097561,75.609756097561,24.390243902439
"34","14","4",0,1,0,4,1,3,6,8,1,4,4,10,4,10,8,13,25,55,80,13,7,16.25,8.75,68.75,31.25
"35","14","5",0,2,4,4,2,5,3,6,2,6,3,5,5,3,5,7,26,39,65,7,8,10.7692307692308,12.3076923076923,60,40
"36","14","6",0,0,3,1,3,2,0,7,0,4,2,6,1,6,7,23,16,52,68,23,4,33.8235294117647,5.88235294117647,76.4705882352941,23.5294117647059
"37","15","1",0,1,1,1,0,0,2,1,1,1,0,1,2,1,1,2,8,10,18,2,0,11.1111111111111,0,55.5555555555556,44.4444444444444
"38","15","2",0,0,0,0,0,0,0,0,0,0,0,0,0,0,0,0,1,1,2,0,0,0,0,50,50
"39","15","3",0,0,0,0,0,5,0,0,0,0,4,0,0,0,0,0,6,6,12,0,9,0,75,50,50
"40","15","4",0,0,0,0,0,3,0,0,0,0,2,0,0,0,0,0,4,4,8,0,5,0,62.5,50,50
"41","15","5",0,0,0,0,0,2,0,0,0,0,1,0,0,0,0,0,3,3,6,0,3,0,50,50,50
"42","15","6",0,0,0,0,0,1,0,0,0,0,1,0,0,0,0,0,3,2,5,0,2,0,40,40,60
"43","16","1",6,6,7,16,8,11,16,17,7,17,12,17,16,18,17,10,90,114,204,16,23,7.84313725490196,11.2745098039216,55.8823529411765,44.1176470588235
"44","16","2",9,4,7,9,11,15,11,8,4,13,19,9,6,13,8,10,76,83,159,19,34,11.9496855345912,21.3836477987421,52.2012578616352,47.7987421383648
"45","16","3",10,5,7,4,6,20,7,9,5,6,20,12,5,11,9,13,70,82,152,23,40,15.1315789473684,26.3157894736842,53.9473684210526,46.0526315789474
"46","16","4",31,11,11,5,11,4,4,2,12,5,4,1,5,1,2,1,82,31,113,32,8,28.3185840707965,7.07964601769912,27.4336283185841,72.5663716814159
"47","16","5",27,10,8,4,8,2,7,0,11,2,2,2,5,2,0,0,69,24,93,27,4,29.0322580645161,4.3010752688172,25.8064516129032,74.1935483870968
"48","16","6",31,8,10,1,10,4,1,0,8,3,4,0,1,0,0,0,67,17,84,31,8,36.9047619047619,9.52380952380952,20.2380952380952,79.7619047619048
"49","17","1",0,2,0,4,0,4,3,9,2,1,4,8,3,8,8,22,22,59,81,22,8,27.1604938271605,9.87654320987654,72.8395061728395,27.1604938271605
"50","17","2",1,2,1,1,0,3,1,2,2,1,2,2,3,1,3,17,13,32,45,18,5,40,11.1111111111111,71.1111111111111,28.8888888888889
"51","17","3",0,1,0,2,0,1,1,3,1,1,1,2,2,2,2,1,8,15,23,1,2,4.34782608695652,8.69565217391304,65.2173913043478,34.7826086956522
"52","17","4",0,0,0,0,0,0,1,0,0,0,0,1,0,1,0,0,2,4,6,0,0,0,0,66.6666666666667,33.3333333333333
"53","17","5",2,1,1,0,0,1,0,0,0,0,0,0,0,0,0,0,6,2,8,2,1,25,12.5,25,75
"54","17","6",0,0,1,0,0,0,0,0,0,1,0,0,0,0,0,0,3,2,5,0,0,0,0,40,60
"55","18","1",2,4,5,4,4,6,3,4,4,4,5,3,5,2,4,3,34,31,65,5,11,7.69230769230769,16.9230769230769,47.6923076923077,52.3076923076923
"56","18","2",15,7,4,4,4,2,6,1,7,1,2,4,4,3,1,0,44,24,68,15,4,22.0588235294118,5.88235294117647,35.2941176470588,64.7058823529412
"57","18","3",3,5,2,6,4,4,6,7,5,3,5,7,4,8,7,4,38,45,83,7,9,8.43373493975904,10.8433734939759,54.2168674698795,45.7831325301205
"58","18","4",1,4,4,3,3,6,4,2,4,3,4,3,4,2,2,2,28,26,54,3,10,5.55555555555556,18.5185185185185,48.1481481481481,51.8518518518519
"59","18","5",4,4,2,5,3,4,5,1,4,3,4,2,4,2,1,2,29,24,53,6,8,11.3207547169811,15.0943396226415,45.2830188679245,54.7169811320755
"60","18","6",5,5,3,4,3,1,4,4,5,2,1,4,4,5,4,5,30,32,62,10,2,16.1290322580645,3.2258064516129,51.6129032258064,48.3870967741936
"61","19","1",0,0,0,1,0,4,5,5,0,1,4,9,2,8,5,11,17,41,58,11,8,18.9655172413793,13.7931034482759,70.6896551724138,29.3103448275862
"62","19","2",0,0,1,1,2,6,2,6,0,2,7,7,0,8,6,5,19,37,56,5,13,8.92857142857143,23.2142857142857,66.0714285714286,33.9285714285714
"63","19","3",0,0,1,1,0,6,5,5,0,2,5,9,2,8,6,6,19,40,59,6,11,10.1694915254237,18.6440677966102,67.7966101694915,32.2033898305085
"64","19","4",0,0,0,0,0,0,2,7,0,0,0,9,0,9,7,39,9,67,76,39,0,51.3157894736842,0,88.1578947368421,11.8421052631579
"65","19","5",0,1,2,2,2,3,5,1,1,3,3,4,2,4,2,1,17,22,39,1,6,2.56410256410256,15.3846153846154,56.4102564102564,43.5897435897436
"66","19","6",0,1,0,2,1,0,1,2,1,1,1,2,1,3,3,11,8,25,33,11,1,33.3333333333333,3.03030303030303,75.7575757575758,24.2424242424242
"67","2","1",1,1,5,4,5,11,9,1,1,8,11,6,4,6,1,0,38,39,77,1,22,1.2987012987013,28.5714285714286,50.6493506493507,49.3506493506493
"68","2","2",0,4,12,4,12,52,10,8,4,11,52,14,3,15,8,5,103,114,217,5,104,2.30414746543779,47.926267281106,52.5345622119816,47.4654377880184
"69","2","3",6,13,22,2,20,281,7,7,13,11,278,12,4,10,7,1,359,338,697,7,559,1.00430416068867,80.2008608321377,48.493543758967,51.506456241033
"70","2","4",0,3,10,2,12,416,7,3,3,9,417,8,0,10,3,2,454,454,908,2,833,0.220264317180617,91.7400881057269,50,50
"71","2","5",1,3,13,3,12,354,11,1,3,13,353,9,4,8,1,0,400,392,792,1,707,0.126262626262626,89.2676767676768,49.4949494949495,50.5050505050505
"72","2","6",1,2,7,0,7,83,3,0,2,5,84,3,0,4,0,0,105,99,204,1,167,0.490196078431373,81.8627450980392,48.5294117647059,51.4705882352941
"73","20","1",3,5,8,2,7,8,4,0,4,5,7,3,2,2,0,0,38,25,63,3,15,4.76190476190476,23.8095238095238,39.6825396825397,60.3174603174603
"74","20","2",0,0,0,0,1,4,3,1,0,0,5,4,0,4,1,0,11,15,26,0,9,0,34.6153846153846,57.6923076923077,42.3076923076923
"75","20","3",0,0,1,0,0,1,1,0,0,1,0,1,1,0,0,0,4,5,9,0,1,0,11.1111111111111,55.5555555555556,44.4444444444444
"76","20","4",0,0,0,0,0,1,0,0,0,0,1,0,0,0,0,0,3,2,5,0,2,0,40,40,60
"77","20","5",1,2,2,1,3,2,3,1,2,1,4,3,0,4,1,2,17,18,35,3,6,8.57142857142857,17.1428571428571,51.4285714285714,48.5714285714286
"78","20","6",0,0,1,2,2,1,1,3,0,2,2,2,0,3,2,7,10,21,31,7,3,22.5806451612903,9.67741935483871,67.741935483871,32.258064516129
"79","21","1",0,2,0,2,2,1,2,1,2,1,3,1,1,3,1,0,12,13,25,0,4,0,16,52,48
"80","21","2",0,0,0,0,0,0,0,0,0,0,0,0,0,0,0,0,0,0,0,0,0,NA,NA,NA,NA
"81","21","3",0,0,0,0,0,0,0,0,0,0,0,0,0,0,0,0,2,1,3,0,0,0,0,33.3333333333333,66.6666666666667
"82","21","4",0,0,0,0,0,0,0,0,0,0,0,0,0,0,0,0,2,0,2,0,0,0,0,0,100
"83","21","5",0,0,0,0,0,0,0,0,0,0,0,0,0,0,0,0,2,1,3,0,0,0,0,33.3333333333333,66.6666666666667
"84","21","6",0,0,0,0,0,0,0,0,0,0,0,0,0,0,0,0,2,1,3,0,0,0,0,33.3333333333333,66.6666666666667
"85","22","1",0,0,2,1,2,2,2,2,0,3,2,3,1,3,3,0,12,17,29,0,4,0,13.7931034482759,58.6206896551724,41.3793103448276
"86","22","2",0,0,0,0,0,0,0,0,0,0,0,0,0,0,0,0,0,0,0,0,0,NA,NA,NA,NA
"87","22","3",2,0,0,0,0,0,0,0,0,0,0,0,0,0,0,0,5,0,5,2,0,40,0,0,100
"88","22","4",0,0,0,1,1,0,1,0,0,1,2,0,0,1,0,0,5,5,10,0,2,0,20,50,50
"89","22","5",0,0,0,0,0,0,0,0,0,0,0,0,0,0,0,0,0,0,0,0,0,NA,NA,NA,NA
"90","22","6",0,0,0,0,0,2,0,0,0,0,2,0,0,0,0,0,4,3,7,0,4,0,57.1428571428571,42.8571428571429,57.1428571428571
"91","23","1",2,2,1,1,0,6,3,5,2,0,4,7,2,5,4,47,20,74,94,49,10,52.1276595744681,10.6382978723404,78.7234042553192,21.2765957446809
"92","23","2",0,0,0,0,0,0,0,1,0,0,0,1,0,1,1,117,1,123,124,117,0,94.3548387096774,0,99.1935483870968,0.806451612903226
"93","23","3",0,0,0,0,0,0,0,2,0,0,0,2,0,2,2,74,2,83,85,74,0,87.0588235294118,0,97.6470588235294,2.35294117647059
"94","23","4",0,0,0,1,0,0,0,6,0,1,0,5,1,4,5,52,7,71,78,52,0,66.6666666666667,0,91.025641025641,8.97435897435897
"95","23","5",0,0,0,0,0,0,0,1,0,0,0,1,0,1,1,39,1,45,46,39,0,84.7826086956522,0,97.8260869565217,2.17391304347826
"96","23","6",0,0,0,0,0,1,0,2,0,0,1,2,0,2,2,17,3,27,30,17,2,56.6666666666667,6.66666666666667,90,10
"97","24","1",7,3,4,1,4,8,3,3,3,2,8,5,2,5,4,6,35,36,71,13,16,18.3098591549296,22.5352112676056,50.7042253521127,49.2957746478873
"98","24","2",16,9,3,7,3,6,7,2,9,1,6,2,7,2,2,1,54,32,86,17,12,19.7674418604651,13.953488372093,37.2093023255814,62.7906976744186
"99","24","3",2,2,5,1,4,1,0,2,2,4,0,1,1,1,2,5,18,18,36,7,1,19.4444444444444,2.77777777777778,50,50
"100","24","4",3,2,4,5,4,3,4,4,2,7,2,4,5,3,4,8,30,37,67,11,5,16.4179104477612,7.46268656716418,55.2238805970149,44.7761194029851
"101","24","5",0,2,6,2,3,15,5,1,2,6,12,4,5,1,1,1,35,34,69,1,27,1.44927536231884,39.1304347826087,49.2753623188406,50.7246376811594
"102","24","6",1,3,1,2,1,2,1,1,3,0,2,1,2,1,1,0,13,12,25,1,4,4,16,48,52
"103","25","1",5,8,9,2,10,8,3,1,9,3,9,2,2,2,1,0,49,28,77,5,17,6.49350649350649,22.0779220779221,36.3636363636364,63.6363636363636
"104","25","2",2,3,2,5,2,5,5,3,3,4,4,4,5,3,3,4,28,32,60,6,9,10,15,53.3333333333333,46.6666666666667
"105","25","3",10,4,4,4,1,7,6,6,3,4,4,8,6,6,6,8,43,47,90,18,11,20,12.2222222222222,52.2222222222222,47.7777777777778
"106","25","4",9,9,6,8,7,7,9,5,8,5,8,7,6,8,5,3,61,52,113,12,15,10.6194690265487,13.2743362831858,46.0176991150442,53.9823008849558
"107","25","5",1,2,5,2,0,6,6,7,2,5,1,12,7,7,8,22,30,66,96,23,7,23.9583333333333,7.29166666666667,68.75,31.25
"108","25","6",0,1,1,3,2,3,4,10,1,3,4,11,2,12,10,16,25,61,86,16,7,18.6046511627907,8.13953488372093,70.9302325581395,29.0697674418605
"109","26","1",5,6,7,1,5,19,11,4,6,2,16,14,3,12,4,3,59,62,121,8,35,6.61157024793388,28.9256198347107,51.2396694214876,48.7603305785124
"110","26","2",0,0,0,0,0,5,6,4,0,1,5,10,1,9,4,2,17,33,50,2,10,4,20,66,34
"111","26","3",3,2,4,0,3,10,1,0,2,2,9,1,1,0,0,0,25,16,41,3,19,7.31707317073171,46.3414634146341,39.0243902439024,60.9756097560976
"112","26","4",0,2,4,2,2,5,3,1,2,4,4,2,3,1,1,0,21,18,39,0,9,0,23.0769230769231,46.1538461538462,53.8461538461538
"113","26","5",10,3,3,2,3,3,3,0,4,2,3,1,3,1,0,0,30,14,44,10,6,22.7272727272727,13.6363636363636,31.8181818181818,68.1818181818182
"114","26","6",10,5,8,1,7,5,1,0,4,4,5,0,1,0,0,0,39,15,54,10,10,18.5185185185185,18.5185185185185,27.7777777777778,72.2222222222222
"115","27","1",7,7,7,5,8,2,3,2,7,6,3,0,4,1,2,1,43,25,68,8,5,11.7647058823529,7.35294117647059,36.7647058823529,63.2352941176471
"116","27","2",0,3,4,2,2,6,4,2,3,2,4,4,3,2,2,0,24,22,46,0,10,0,21.7391304347826,47.8260869565217,52.1739130434783
"117","27","3",2,1,1,1,0,3,3,3,1,1,2,5,2,4,2,3,14,23,37,5,5,13.5135135135135,13.5135135135135,62.1621621621622,37.8378378378378
"118","27","4",0,0,1,0,0,1,0,1,0,1,0,1,1,0,2,9,4,16,20,9,1,45,5,80,20
"119","27","5",2,1,1,0,0,7,0,2,1,0,7,2,1,2,3,1,15,18,33,3,14,9.09090909090909,42.4242424242424,54.5454545454545,45.4545454545455
"120","27","6",0,0,6,5,6,7,5,3,0,11,7,3,4,4,3,1,33,35,68,1,14,1.47058823529412,20.5882352941176,51.4705882352941,48.5294117647059
"121","28","1",22,6,5,3,5,5,4,1,6,3,5,2,3,2,1,0,53,23,76,22,10,28.9473684210526,13.1578947368421,30.2631578947368,69.7368421052632
"122","28","2",0,0,0,0,0,0,0,0,0,0,0,0,0,0,0,0,0,0,0,0,0,NA,NA,NA,NA
"123","28","3",0,0,0,0,0,0,0,0,0,0,0,0,0,0,0,0,0,0,0,0,0,NA,NA,NA,NA
"124","28","4",0,0,0,0,0,0,0,0,0,0,0,0,0,0,0,0,0,0,0,0,0,NA,NA,NA,NA
"125","28","5",0,0,0,0,0,0,0,0,0,0,0,0,0,0,0,0,0,0,0,0,0,NA,NA,NA,NA
"126","28","6",0,0,0,0,0,0,0,0,0,0,0,0,0,0,0,0,0,0,0,0,0,NA,NA,NA,NA
"127","29","1",16,9,9,7,8,5,4,5,9,7,5,2,7,2,5,9,65,47,112,25,10,22.3214285714286,8.92857142857143,41.9642857142857,58.0357142857143
"128","29","2",15,10,13,2,14,5,2,0,9,6,6,0,1,1,0,0,63,24,87,15,11,17.2413793103448,12.6436781609195,27.5862068965517,72.4137931034483
"129","29","3",16,11,18,0,19,7,0,0,11,8,7,0,0,0,0,0,73,27,100,16,14,16,14,27,73
"130","29","4",1,3,4,3,6,16,6,1,3,4,17,4,2,5,1,2,42,39,81,3,33,3.7037037037037,40.7407407407407,48.1481481481481,51.8518518518519
"131","29","5",5,3,3,0,3,9,1,0,3,0,9,1,0,1,0,0,26,15,41,5,18,12.1951219512195,43.9024390243902,36.5853658536585,63.4146341463415
"132","29","6",2,3,3,1,3,5,1,1,2,1,5,1,0,2,1,1,20,15,35,3,10,8.57142857142857,28.5714285714286,42.8571428571429,57.1428571428571
"133","3","1",0,1,3,0,1,7,2,8,1,2,5,10,2,8,8,25,22,64,86,25,12,29.0697674418605,13.953488372093,74.4186046511628,25.5813953488372
"134","3","2",0,0,0,0,0,10,1,0,0,0,10,1,0,2,1,0,12,16,28,0,20,0,71.4285714285714,57.1428571428571,42.8571428571429
"135","3","3",0,0,0,0,0,11,1,0,0,0,11,1,0,2,0,0,13,16,29,0,22,0,75.8620689655172,55.1724137931034,44.8275862068966
"136","3","4",0,0,0,0,0,36,0,0,0,0,35,0,0,0,0,0,37,37,74,0,71,0,95.945945945946,50,50
"137","3","5",0,0,0,0,0,171,1,0,0,0,172,1,0,1,0,0,174,175,349,0,343,0,98.2808022922636,50.1432664756447,49.8567335243553
"138","3","6",0,0,0,0,0,197,1,0,0,0,197,1,0,1,0,0,199,201,400,0,394,0,98.5,50.25,49.75
"139","30","1",3,2,4,1,2,5,0,4,2,3,3,3,3,1,4,15,21,37,58,18,8,31.0344827586207,13.7931034482759,63.7931034482759,36.2068965517241
"140","30","2",0,1,2,3,3,2,2,2,1,4,3,2,2,3,2,0,16,19,35,0,5,0,14.2857142857143,54.2857142857143,45.7142857142857
"141","30","3",2,1,1,0,0,2,1,2,1,0,1,2,1,1,2,0,10,10,20,2,3,10,15,50,50
"142","30","4",0,1,0,1,0,0,1,0,1,0,0,0,1,0,1,0,4,5,9,0,0,0,0,55.5555555555556,44.4444444444444
"143","30","5",0,0,1,1,1,1,0,1,0,1,1,0,0,0,1,0,6,5,11,0,2,0,18.1818181818182,45.4545454545455,54.5454545454545
"144","30","6",3,2,1,1,1,0,0,1,1,0,0,0,0,0,0,3,9,7,16,6,0,37.5,0,43.75,56.25
"145","31","1",1,0,0,1,0,1,1,1,1,1,0,1,2,0,1,5,8,11,19,6,1,31.5789473684211,5.26315789473684,57.8947368421053,42.1052631578947
"146","31","2",0,0,0,2,1,4,1,4,0,2,4,3,2,3,4,9,14,28,42,9,8,21.4285714285714,19.047619047619,66.6666666666667,33.3333333333333
"147","31","3",0,0,0,0,0,0,0,0,0,0,0,0,0,0,0,0,0,0,0,0,0,NA,NA,NA,NA
"148","31","4",0,0,0,0,0,0,0,0,0,0,0,0,0,0,0,0,0,0,0,0,0,NA,NA,NA,NA
"149","31","5",0,0,0,0,0,0,0,0,0,0,0,0,0,0,0,0,0,0,0,0,0,NA,NA,NA,NA
"150","31","6",0,0,0,0,0,0,0,0,0,0,0,0,0,0,0,0,0,0,0,0,0,NA,NA,NA,NA
"151","32","1",0,3,9,3,9,17,5,2,2,9,17,4,2,5,2,0,49,43,92,0,34,0,36.9565217391304,46.7391304347826,53.2608695652174
"152","32","2",16,3,2,1,2,11,2,0,3,0,10,1,1,1,0,0,38,18,56,16,21,28.5714285714286,37.5,32.1428571428571,67.8571428571429
"153","32","3",25,6,6,1,5,2,1,0,6,0,1,1,1,0,0,0,47,11,58,25,3,43.1034482758621,5.17241379310345,18.9655172413793,81.0344827586207
"154","32","4",0,3,5,2,6,6,3,2,4,4,7,2,2,3,2,0,30,24,54,0,13,0,24.0740740740741,44.4444444444444,55.5555555555556
"155","32","5",12,6,6,1,6,5,0,0,6,0,5,0,0,0,0,0,37,13,50,12,10,24,20,26,74
"156","32","6",0,1,0,2,0,1,1,2,1,1,1,2,2,2,2,0,8,13,21,0,2,0,9.52380952380952,61.9047619047619,38.0952380952381
"157","33","1",1,1,0,2,2,2,1,1,1,1,3,0,0,1,0,2,10,11,21,3,5,14.2857142857143,23.8095238095238,52.3809523809524,47.6190476190476
"158","33","2",0,0,0,0,0,0,0,0,0,0,0,0,0,0,0,0,0,0,0,0,0,NA,NA,NA,NA
"159","33","3",0,0,0,0,0,0,0,0,0,0,0,0,1,0,0,0,2,2,4,0,0,0,0,50,50
"160","33","4",28,7,4,3,4,3,3,1,7,0,3,1,3,1,1,2,56,18,74,30,6,40.5405405405405,8.10810810810811,24.3243243243243,75.6756756756757
"161","33","5",0,1,1,2,1,1,1,9,0,2,1,8,1,8,8,34,16,65,81,34,2,41.9753086419753,2.46913580246914,80.2469135802469,19.7530864197531
"162","33","6",0,0,1,0,0,2,1,2,0,1,1,3,1,2,3,22,7,35,42,22,3,52.3809523809524,7.14285714285714,83.3333333333333,16.6666666666667
"163","34","1",7,5,4,1,4,3,0,1,4,0,3,1,0,1,1,1,26,13,39,8,6,20.5128205128205,15.3846153846154,33.3333333333333,66.6666666666667
"164","34","2",0,2,5,0,5,2,0,0,2,3,2,0,0,0,0,0,16,8,24,0,4,0,16.6666666666667,33.3333333333333,66.6666666666667
"165","34","3",5,3,2,1,0,2,3,2,2,0,0,4,2,2,2,0,19,14,33,5,2,15.1515151515152,6.06060606060606,42.4242424242424,57.5757575757576
"166","34","4",2,1,3,0,3,2,1,1,1,2,2,1,0,2,1,0,14,11,25,2,4,8,16,44,56
"167","34","5",0,1,1,2,3,1,2,0,1,2,2,0,0,1,0,0,11,8,19,0,3,0,15.7894736842105,42.1052631578947,57.8947368421053
"168","34","6",0,0,1,1,1,1,1,0,1,1,1,0,1,0,0,0,8,4,12,0,2,0,16.6666666666667,33.3333333333333,66.6666666666667
"169","35","1",12,3,4,1,2,2,1,2,3,2,1,2,3,0,2,0,29,14,43,12,3,27.906976744186,6.97674418604651,32.5581395348837,67.4418604651163
"170","35","2",18,5,6,2,6,0,2,0,6,2,0,0,2,0,0,0,42,10,52,18,0,34.6153846153846,0,19.2307692307692,80.7692307692308
"171","35","3",17,10,11,5,12,8,5,5,10,6,9,5,4,6,5,2,76,47,123,19,17,15.4471544715447,13.8211382113821,38.2113821138211,61.7886178861789
"172","35","4",7,4,4,1,3,4,3,5,3,1,3,8,1,7,5,16,32,46,78,23,7,29.4871794871795,8.97435897435897,58.974358974359,41.025641025641
"173","35","5",0,2,3,2,1,8,4,5,2,3,6,7,4,6,5,7,26,42,68,7,14,10.2941176470588,20.5882352941176,61.7647058823529,38.2352941176471
"174","35","6",0,1,2,2,2,7,3,8,1,4,7,9,3,9,8,12,27,54,81,12,14,14.8148148148148,17.2839506172839,66.6666666666667,33.3333333333333
"175","36","1",1,1,1,3,1,2,3,7,2,3,2,7,4,7,8,15,22,48,70,16,4,22.8571428571429,5.71428571428571,68.5714285714286,31.4285714285714
"176","36","2",2,4,4,6,7,3,6,3,5,6,6,3,3,6,3,3,38,35,73,5,9,6.84931506849315,12.3287671232877,47.9452054794521,52.0547945205479
"177","36","3",0,0,6,2,6,7,1,3,0,8,7,2,2,2,3,9,25,36,61,9,14,14.7540983606557,22.9508196721311,59.0163934426229,40.9836065573771
"178","36","4",0,1,1,2,2,3,1,4,1,3,4,3,1,4,4,5,16,26,42,5,7,11.9047619047619,16.6666666666667,61.9047619047619,38.0952380952381
"179","36","5",0,0,1,0,1,7,1,4,0,1,6,5,0,4,4,11,15,33,48,11,13,22.9166666666667,27.0833333333333,68.75,31.25
"180","36","6",0,0,1,3,1,2,3,4,0,4,2,4,4,3,4,8,16,30,46,8,4,17.3913043478261,8.69565217391304,65.2173913043478,34.7826086956522
"181","37","1",6,6,4,4,3,5,4,1,5,2,5,1,4,1,1,1,35,21,56,7,10,12.5,17.8571428571429,37.5,62.5
"182","37","2",2,3,3,0,3,1,1,0,3,1,1,1,1,1,0,0,15,9,24,2,2,8.33333333333333,8.33333333333333,37.5,62.5
"183","37","3",0,0,0,1,1,1,0,1,0,1,2,0,0,0,0,0,4,6,10,0,3,0,30,60,40
"184","37","4",0,0,0,0,0,2,0,0,0,0,2,0,0,0,0,0,3,4,7,0,4,0,57.1428571428571,57.1428571428571,42.8571428571429
"185","37","5",3,0,1,0,1,0,0,0,1,0,0,0,0,0,0,0,8,1,9,3,0,33.3333333333333,0,11.1111111111111,88.8888888888889
"186","37","6",0,0,0,0,0,0,0,0,0,0,0,0,0,0,0,0,1,2,3,0,0,0,0,66.6666666666667,33.3333333333333
"187","38","1",0,0,0,0,0,2,4,0,0,1,2,4,1,4,1,5,8,19,27,5,4,18.5185185185185,14.8148148148148,70.3703703703704,29.6296296296296
"188","38","2",0,0,1,0,0,1,1,0,0,1,0,2,1,0,0,0,4,6,10,0,1,0,10,60,40
"189","38","3",0,0,0,0,0,0,0,0,0,0,0,0,0,0,0,0,0,0,0,0,0,NA,NA,NA,NA
"190","38","4",0,0,0,0,0,0,0,0,0,0,0,0,0,0,0,0,0,0,0,0,0,NA,NA,NA,NA
"191","38","5",0,0,0,0,0,0,0,0,0,0,0,0,0,0,0,0,0,0,0,0,0,NA,NA,NA,NA
"192","38","6",0,0,0,0,0,0,0,0,0,0,0,0,0,0,0,0,0,0,0,0,0,NA,NA,NA,NA
"193","39","1",1,2,1,0,1,2,1,1,2,0,2,2,1,1,1,5,11,15,26,6,4,23.0769230769231,15.3846153846154,57.6923076923077,42.3076923076923
"194","39","2",0,0,0,0,0,0,0,0,0,0,0,1,0,1,0,0,1,4,5,0,0,0,0,80,20
"195","39","3",0,0,0,0,0,0,0,0,0,0,0,1,0,0,0,0,1,3,4,0,0,0,0,75,25
"196","39","4",0,0,0,0,0,0,0,0,0,0,0,0,0,0,0,0,0,0,0,0,0,NA,NA,NA,NA
"197","39","5",0,0,0,0,0,0,0,0,0,0,0,0,0,0,0,0,0,0,0,0,0,NA,NA,NA,NA
"198","39","6",0,0,0,0,0,0,0,0,0,0,0,0,0,0,0,0,0,0,0,0,0,NA,NA,NA,NA
"199","4","1",68,12,13,3,16,10,3,4,13,4,12,4,1,6,4,1,132,45,177,69,22,38.9830508474576,12.4293785310734,25.4237288135593,74.5762711864407
"200","4","2",103,8,8,1,8,3,2,0,8,1,3,1,1,1,0,0,136,15,151,103,6,68.2119205298013,3.97350993377483,9.93377483443709,90.0662251655629
"201","4","3",170,2,2,0,2,0,0,0,2,0,0,0,0,0,0,0,179,2,181,170,0,93.9226519337017,0,1.10497237569061,98.8950276243094
"202","4","4",138,3,3,0,3,0,0,0,3,0,0,0,0,0,0,0,150,3,153,138,0,90.1960784313726,0,1.96078431372549,98.0392156862745
"203","4","5",119,4,4,0,4,0,0,0,4,0,0,0,0,0,0,0,134,4,138,119,0,86.231884057971,0,2.89855072463768,97.1014492753623
"204","4","6",126,2,1,0,1,2,0,0,1,0,2,0,0,0,0,0,134,4,138,126,4,91.304347826087,2.89855072463768,2.89855072463768,97.1014492753623
"205","40","1",24,6,8,0,7,7,1,1,6,2,6,2,1,1,1,0,57,19,76,24,13,31.5789473684211,17.1052631578947,25,75
"206","40","2",0,3,4,1,4,4,1,4,3,2,3,4,1,3,4,10,22,32,54,10,7,18.5185185185185,12.962962962963,59.2592592592593,40.7407407407407
"207","40","3",0,1,2,1,2,0,1,2,1,2,0,2,2,2,3,4,11,17,28,4,0,14.2857142857143,0,60.7142857142857,39.2857142857143
"208","40","4",0,0,1,0,1,3,1,1,0,1,3,2,0,2,2,0,8,12,20,0,6,0,30,60,40
"209","40","5",0,0,0,1,0,0,0,0,0,1,0,0,1,0,1,2,2,7,9,2,0,22.2222222222222,0,77.7777777777778,22.2222222222222
"210","40","6",0,0,0,0,0,0,0,1,0,0,0,0,0,0,1,3,2,6,8,3,0,37.5,0,75,25
"211","41","1",0,0,0,1,0,0,0,1,0,1,0,0,1,0,0,2,2,7,9,2,0,22.2222222222222,0,77.7777777777778,22.2222222222222
"212","41","2",0,0,0,0,0,0,0,0,0,0,0,0,0,0,0,0,0,0,0,0,0,NA,NA,NA,NA
"213","41","3",0,0,0,0,0,0,0,0,0,0,0,0,0,0,0,0,0,0,0,0,0,NA,NA,NA,NA
"214","41","4",0,0,0,0,0,0,0,0,0,0,0,0,0,0,0,0,0,0,0,0,0,NA,NA,NA,NA
"215","41","5",0,0,0,0,0,0,0,0,0,0,0,0,0,0,0,0,0,0,0,0,0,NA,NA,NA,NA
"216","41","6",0,0,0,0,0,0,0,0,0,0,0,0,0,0,0,0,0,0,0,0,0,NA,NA,NA,NA
"217","42","1",1,1,0,2,1,0,2,5,1,1,0,5,2,5,5,40,14,60,74,41,0,55.4054054054054,0,81.0810810810811,18.9189189189189
"218","42","2",5,1,0,4,1,3,5,6,1,3,4,7,3,8,5,12,25,46,71,17,7,23.943661971831,9.85915492957746,64.7887323943662,35.2112676056338
"219","42","3",0,0,0,2,1,2,1,8,0,2,3,7,1,8,8,26,14,58,72,26,5,36.1111111111111,6.94444444444444,80.5555555555556,19.4444444444444
"220","42","4",0,0,0,1,1,1,1,4,0,1,2,5,0,6,5,6,9,27,36,6,3,16.6666666666667,8.33333333333333,75,25
"221","42","5",0,0,0,1,0,1,1,2,0,1,1,2,1,2,2,4,5,16,21,4,2,19.047619047619,9.52380952380952,76.1904761904762,23.8095238095238
"222","42","6",0,0,0,0,0,0,0,1,0,0,0,1,0,0,0,19,1,23,24,19,0,79.1666666666667,0,95.8333333333333,4.16666666666667
"223","43","1",21,6,4,3,5,3,4,3,6,1,4,5,2,6,4,13,50,43,93,34,7,36.5591397849462,7.52688172043011,46.2365591397849,53.7634408602151
"224","43","2",46,7,6,7,8,3,7,2,6,6,5,2,4,5,2,0,87,32,119,46,8,38.6554621848739,6.72268907563025,26.890756302521,73.109243697479
"225","43","3",5,2,5,4,4,8,8,6,3,7,7,9,6,8,6,5,45,51,96,10,15,10.4166666666667,15.625,53.125,46.875
"226","43","4",0,0,1,1,2,4,3,2,0,2,5,4,0,5,2,0,15,19,34,0,9,0,26.4705882352941,55.8823529411765,44.1176470588235
"227","43","5",0,0,0,1,0,0,0,1,0,1,0,1,1,1,1,2,3,9,12,2,0,16.6666666666667,0,75,25
"228","43","6",0,2,1,5,1,0,5,4,2,4,0,4,5,4,4,12,19,37,56,12,0,21.4285714285714,0,66.0714285714286,33.9285714285714
"229","44","1",13,6,6,7,4,4,7,3,6,7,3,3,9,2,3,5,52,39,91,18,7,19.7802197802198,7.69230769230769,42.8571428571429,57.1428571428571
"230","44","2",3,5,7,5,6,6,3,4,5,7,5,2,6,1,4,10,42,40,82,13,11,15.8536585365854,13.4146341463415,48.780487804878,51.219512195122
"231","44","3",8,6,5,5,8,8,4,7,6,4,11,5,2,8,7,1,52,46,98,9,19,9.18367346938776,19.3877551020408,46.9387755102041,53.0612244897959
"232","44","4",11,6,5,3,5,6,3,2,6,1,6,2,2,3,2,1,42,25,67,12,12,17.910447761194,17.910447761194,37.3134328358209,62.6865671641791
"233","44","5",7,5,2,3,2,6,4,0,4,0,6,2,2,2,0,0,30,18,48,7,12,14.5833333333333,25,37.5,62.5
"234","44","6",7,4,4,4,6,8,5,2,4,4,9,3,2,4,2,0,41,30,71,7,17,9.85915492957746,23.943661971831,42.2535211267606,57.7464788732394
"235","45","1",32,8,5,2,4,2,1,3,8,0,1,2,3,1,3,0,59,19,78,32,3,41.025641025641,3.84615384615385,24.3589743589744,75.6410256410256
"236","45","2",20,6,1,6,2,0,4,2,6,1,1,1,4,2,2,1,42,20,62,21,1,33.8709677419355,1.61290322580645,32.258064516129,67.741935483871
"237","45","3",14,8,8,4,7,3,4,2,8,4,3,1,5,1,2,1,52,26,78,15,6,19.2307692307692,7.69230769230769,33.3333333333333,66.6666666666667
"238","45","4",1,1,3,2,2,4,0,5,1,3,3,3,2,3,5,11,19,33,52,12,7,23.0769230769231,13.4615384615385,63.4615384615385,36.5384615384615
"239","45","5",0,0,1,0,1,5,0,2,0,1,5,2,0,3,3,4,10,20,30,4,10,13.3333333333333,33.3333333333333,66.6666666666667,33.3333333333333
"240","45","6",5,0,0,2,3,1,3,1,1,2,4,2,0,4,1,0,18,14,32,5,5,15.625,15.625,43.75,56.25
"241","46","1",19,11,11,6,11,17,5,4,11,6,17,3,6,4,4,3,85,56,141,22,34,15.6028368794326,24.113475177305,39.7163120567376,60.2836879432624
"242","46","2",5,3,5,2,8,15,3,1,3,5,17,2,0,4,1,0,44,33,77,5,32,6.49350649350649,41.5584415584416,42.8571428571429,57.1428571428571
"243","46","3",1,3,3,1,2,25,10,1,2,1,24,10,1,10,1,1,47,52,99,2,49,2.02020202020202,49.4949494949495,52.5252525252525,47.4747474747475
"244","46","4",1,2,0,2,0,22,11,3,2,0,23,12,2,13,3,5,43,61,104,6,45,5.76923076923077,43.2692307692308,58.6538461538462,41.3461538461538
"245","46","5",1,1,1,0,0,3,7,10,1,0,2,17,1,16,11,24,24,74,98,25,5,25.5102040816327,5.10204081632653,75.5102040816327,24.4897959183673
"246","46","6",0,1,2,3,1,4,5,11,1,4,3,14,4,12,11,25,28,76,104,25,7,24.0384615384615,6.73076923076923,73.0769230769231,26.9230769230769
"247","47","1",70,12,7,5,8,1,6,0,12,1,2,1,5,1,0,0,111,23,134,70,3,52.2388059701493,2.23880597014925,17.1641791044776,82.8358208955224
"248","47","2",27,9,8,5,8,8,5,2,8,4,9,2,4,3,2,1,74,34,108,28,17,25.9259259259259,15.7407407407407,31.4814814814815,68.5185185185185
"249","47","3",13,4,3,4,6,2,4,0,4,4,5,0,2,2,0,0,38,18,56,13,7,23.2142857142857,12.5,32.1428571428571,67.8571428571429
"250","47","4",1,1,1,1,2,16,4,0,1,1,18,3,0,4,0,0,28,28,56,1,34,1.78571428571429,60.7142857142857,50,50
"251","47","5",0,0,0,1,1,6,0,1,0,1,7,0,0,1,1,1,10,13,23,1,13,4.34782608695652,56.5217391304348,56.5217391304348,43.4782608695652
"252","47","6",0,0,0,1,1,27,4,0,0,1,28,3,0,4,0,0,34,38,72,0,55,0,76.3888888888889,52.7777777777778,47.2222222222222
"253","49","1",0,0,1,0,1,0,0,0,0,1,1,0,0,0,0,0,4,3,7,0,1,0,14.2857142857143,42.8571428571429,57.1428571428571
"254","49","2",0,0,0,0,0,0,0,0,0,0,0,0,0,0,0,0,0,0,0,0,0,NA,NA,NA,NA
"255","49","3",0,0,0,0,0,0,0,0,0,0,0,0,0,0,0,0,0,0,0,0,0,NA,NA,NA,NA
"256","49","4",0,0,0,0,0,0,0,0,0,0,0,0,0,0,0,0,0,0,0,0,0,NA,NA,NA,NA
"257","49","5",0,0,0,0,0,0,0,0,0,0,0,0,0,0,0,0,0,0,0,0,0,NA,NA,NA,NA
"258","49","6",0,0,0,0,0,0,0,0,0,0,0,0,0,0,0,0,0,0,0,0,0,NA,NA,NA,NA
"259","5","1",2,3,3,2,4,7,4,0,3,2,7,2,2,2,0,0,27,19,46,2,14,4.34782608695652,30.4347826086957,41.304347826087,58.695652173913
"260","5","2",17,2,2,0,2,1,1,0,3,0,1,1,0,1,0,0,28,6,34,17,2,50,5.88235294117647,17.6470588235294,82.3529411764706
"261","5","3",52,7,8,1,8,1,0,2,7,2,1,1,1,1,2,0,82,15,97,52,2,53.6082474226804,2.06185567010309,15.4639175257732,84.5360824742268
"262","5","4",65,6,9,0,9,2,0,0,7,2,2,0,0,0,0,0,94,11,105,65,4,61.9047619047619,3.80952380952381,10.4761904761905,89.5238095238095
"263","5","5",47,5,5,3,6,3,3,0,6,2,4,0,2,1,0,0,75,15,90,47,7,52.2222222222222,7.77777777777778,16.6666666666667,83.3333333333333
"264","5","6",52,8,8,0,7,3,0,0,7,0,3,0,0,0,0,0,80,11,91,52,6,57.1428571428571,6.59340659340659,12.0879120879121,87.9120879120879
"265","50","1",9,9,8,4,11,4,2,6,9,4,7,3,2,6,6,4,55,42,97,13,11,13.4020618556701,11.340206185567,43.298969072165,56.701030927835
"266","50","2",21,8,14,4,11,9,3,6,7,11,6,5,7,2,6,6,78,51,129,27,15,20.9302325581395,11.6279069767442,39.5348837209302,60.4651162790698
"267","50","3",1,1,3,1,4,4,1,1,1,3,5,1,0,2,1,2,18,16,34,3,9,8.82352941176471,26.4705882352941,47.0588235294118,52.9411764705882
"268","50","4",0,1,0,1,1,0,1,0,1,0,1,0,0,1,1,0,5,6,11,0,1,0,9.09090909090909,54.5454545454545,45.4545454545455
"269","50","5",0,0,0,1,0,0,0,2,0,1,1,0,1,1,2,2,5,9,14,2,1,14.2857142857143,7.14285714285714,64.2857142857143,35.7142857142857
"270","50","6",0,0,0,1,0,0,1,1,0,1,0,1,1,1,1,0,5,6,11,0,0,0,0,54.5454545454545,45.4545454545455
"271","51","1",4,2,2,1,1,3,4,4,2,1,2,6,2,5,3,10,21,34,55,14,5,25.4545454545455,9.09090909090909,61.8181818181818,38.1818181818182
"272","51","2",0,1,0,1,0,0,1,2,2,0,0,2,1,2,2,1,8,10,18,1,0,5.55555555555556,0,55.5555555555556,44.4444444444444
"273","51","3",0,0,1,0,0,1,0,0,0,0,0,0,0,0,0,0,3,2,5,0,1,0,20,40,60
"274","51","4",0,0,0,0,0,0,0,0,0,0,0,0,0,0,0,0,0,0,0,0,0,NA,NA,NA,NA
"275","51","5",0,0,0,0,0,0,0,0,0,0,0,0,0,0,0,0,0,0,0,0,0,NA,NA,NA,NA
"276","51","6",0,0,0,0,0,0,0,1,0,0,0,0,0,0,0,11,1,14,15,11,0,73.3333333333333,0,93.3333333333333,6.66666666666667
"277","52","1",2,0,0,0,1,0,0,0,1,0,0,0,0,0,0,0,6,1,7,2,0,28.5714285714286,0,14.2857142857143,85.7142857142857
"278","52","2",0,0,0,0,0,1,0,1,0,0,1,1,0,1,0,1,2,7,9,1,2,11.1111111111111,22.2222222222222,77.7777777777778,22.2222222222222
"279","52","3",0,0,0,0,0,0,0,0,0,0,0,0,0,0,0,2,0,5,5,2,0,40,0,100,0
"280","52","4",0,0,0,0,0,0,0,0,0,0,0,0,0,0,0,0,0,0,0,0,0,NA,NA,NA,NA
"281","52","5",0,0,0,0,0,0,0,0,0,0,0,0,0,0,0,0,0,0,0,0,0,NA,NA,NA,NA
"282","52","6",0,0,0,0,0,0,0,0,0,0,0,0,0,0,0,0,0,0,0,0,0,NA,NA,NA,NA
"283","53","1",8,7,10,7,11,7,3,8,7,10,8,4,5,5,8,11,62,60,122,19,15,15.5737704918033,12.2950819672131,49.1803278688525,50.8196721311475
"284","53","2",11,9,7,4,4,4,3,3,9,2,1,2,7,0,4,4,46,31,77,15,5,19.4805194805195,6.49350649350649,40.2597402597403,59.7402597402597
"285","53","3",4,4,2,3,4,5,2,2,4,2,6,1,2,2,2,1,28,21,49,5,11,10.2040816326531,22.4489795918367,42.8571428571429,57.1428571428571
"286","53","4",0,0,0,1,0,7,1,4,0,1,7,5,1,5,5,2,14,28,42,2,14,4.76190476190476,33.3333333333333,66.6666666666667,33.3333333333333
"287","53","5",1,1,1,1,2,3,2,0,1,1,4,1,0,3,1,1,12,14,26,2,7,7.69230769230769,26.9230769230769,53.8461538461538,46.1538461538462
"288","53","6",0,0,1,2,1,1,1,3,0,3,1,2,2,3,4,7,10,24,34,7,2,20.5882352941176,5.88235294117647,70.5882352941177,29.4117647058824
"289","54","1",13,2,1,1,1,0,0,1,3,0,0,0,1,0,1,0,22,5,27,13,0,48.1481481481481,0,18.5185185185185,81.4814814814815
"290","54","2",19,5,4,1,3,0,1,0,4,0,0,0,1,0,0,0,35,6,41,19,0,46.3414634146341,0,14.6341463414634,85.3658536585366
"291","54","3",4,5,3,4,5,2,5,2,6,2,4,3,3,4,2,0,33,24,57,4,6,7.01754385964912,10.5263157894737,42.1052631578947,57.8947368421053
"292","54","4",11,2,2,1,2,2,4,0,3,1,2,3,2,2,0,0,27,13,40,11,4,27.5,10,32.5,67.5
"293","54","5",18,8,10,1,10,2,1,1,9,3,1,1,2,0,1,0,54,17,71,18,3,25.3521126760563,4.22535211267606,23.943661971831,76.056338028169
"294","54","6",11,4,6,4,5,4,6,0,4,6,4,2,4,2,0,0,42,23,65,11,8,16.9230769230769,12.3076923076923,35.3846153846154,64.6153846153846
"295","55","1",1,0,1,1,1,0,1,0,1,1,0,0,1,0,0,0,8,3,11,1,0,9.09090909090909,0,27.2727272727273,72.7272727272727
"296","55","2",30,6,6,2,5,4,5,1,6,2,3,4,3,3,1,0,62,22,84,30,7,35.7142857142857,8.33333333333333,26.1904761904762,73.8095238095238
"297","55","3",22,9,10,4,11,8,5,0,10,5,9,1,3,2,0,0,72,30,102,22,17,21.5686274509804,16.6666666666667,29.4117647058824,70.5882352941177
"298","55","4",9,7,6,5,8,13,5,3,6,4,16,3,2,6,3,3,58,44,102,12,29,11.7647058823529,28.4313725490196,43.1372549019608,56.8627450980392
"299","55","5",1,2,4,5,4,12,3,7,2,7,12,5,5,5,6,11,38,56,94,12,24,12.7659574468085,25.531914893617,59.5744680851064,40.4255319148936
"300","55","6",15,6,7,4,6,4,3,8,6,5,3,7,5,5,7,8,53,49,102,23,7,22.5490196078431,6.86274509803922,48.0392156862745,51.9607843137255
"301","56","1",33,3,3,1,4,0,2,0,4,1,1,1,1,2,1,3,49,14,63,36,1,57.1428571428571,1.58730158730159,22.2222222222222,77.7777777777778
"302","56","2",64,4,4,0,2,3,3,0,4,0,1,3,1,2,0,0,81,13,94,64,4,68.0851063829787,4.25531914893617,13.8297872340426,86.1702127659574
"303","56","3",12,9,8,3,9,10,2,1,9,2,12,0,1,2,1,0,56,28,84,12,22,14.2857142857143,26.1904761904762,33.3333333333333,66.6666666666667
"304","56","4",18,4,4,1,4,0,1,1,3,1,1,1,0,2,1,1,35,11,46,19,1,41.304347826087,2.17391304347826,23.9130434782609,76.0869565217391
"305","56","5",20,4,4,0,4,0,0,0,4,0,0,0,0,0,0,0,35,4,39,20,0,51.2820512820513,0,10.2564102564103,89.7435897435897
"306","56","6",14,5,4,0,5,0,0,0,5,0,0,0,0,0,0,0,30,6,36,14,0,38.8888888888889,0,16.6666666666667,83.3333333333333
"307","57","1",0,0,0,1,1,1,2,2,0,1,1,4,0,4,2,2,8,16,24,2,2,8.33333333333333,8.33333333333333,66.6666666666667,33.3333333333333
"308","57","2",0,0,0,0,0,0,0,0,0,0,0,0,0,0,0,0,0,0,0,0,0,NA,NA,NA,NA
"309","57","3",0,0,0,0,0,0,0,0,0,0,0,0,0,0,0,0,0,0,0,0,0,NA,NA,NA,NA
"310","57","4",0,0,0,0,0,0,0,0,0,0,0,0,0,0,0,0,1,1,2,0,0,0,0,50,50
"311","57","5",0,0,0,0,1,0,0,0,0,0,0,0,0,0,0,0,3,1,4,0,0,0,0,25,75
"312","57","6",0,0,0,0,0,0,0,0,0,0,0,0,0,0,0,0,0,0,0,0,0,NA,NA,NA,NA
"313","58","1",8,4,5,6,5,7,6,5,4,7,6,6,6,5,5,2,47,43,90,10,13,11.1111111111111,14.4444444444444,47.7777777777778,52.2222222222222
"314","58","2",23,6,7,5,6,5,6,1,7,6,4,2,6,1,1,2,62,29,91,25,9,27.4725274725275,9.89010989010989,31.8681318681319,68.1318681318681
"315","58","3",12,8,11,4,11,8,8,2,8,8,8,6,5,6,3,1,66,46,112,13,16,11.6071428571429,14.2857142857143,41.0714285714286,58.9285714285714
"316","58","4",12,10,9,3,7,15,4,3,10,2,13,4,5,2,3,0,66,39,105,12,28,11.4285714285714,26.6666666666667,37.1428571428571,62.8571428571429
"317","58","5",41,11,11,3,10,4,2,1,10,3,4,0,3,0,1,0,85,22,107,41,8,38.3177570093458,7.47663551401869,20.5607476635514,79.4392523364486
"318","58","6",21,13,11,5,12,4,2,4,13,3,6,1,4,2,4,1,74,35,109,22,10,20.1834862385321,9.1743119266055,32.1100917431193,67.8899082568807
"319","59","1",4,2,0,1,0,0,0,1,1,0,0,0,1,0,1,0,10,4,14,4,0,28.5714285714286,0,28.5714285714286,71.4285714285714
"320","59","2",27,5,4,2,5,3,1,1,5,2,3,0,2,0,1,0,50,14,64,27,6,42.1875,9.375,21.875,78.125
"321","59","3",6,5,6,2,7,6,0,6,4,3,8,4,0,6,6,17,40,49,89,23,14,25.8426966292135,15.7303370786517,55.0561797752809,44.9438202247191
"322","59","4",0,0,3,3,5,13,3,7,0,6,15,7,2,8,7,7,36,53,89,7,28,7.86516853932584,31.4606741573034,59.5505617977528,40.4494382022472
"323","59","5",1,2,8,4,7,11,9,5,2,9,10,10,4,9,4,7,47,58,105,8,21,7.61904761904762,20,55.2380952380952,44.7619047619048
"324","59","6",7,3,5,5,7,6,1,7,3,7,7,4,3,5,7,11,42,49,91,18,13,19.7802197802198,14.2857142857143,53.8461538461538,46.1538461538462
"325","6","1",1,1,4,0,2,2,0,1,1,3,1,1,1,0,1,1,13,10,23,2,3,8.69565217391304,13.0434782608696,43.4782608695652,56.5217391304348
"326","6","2",0,0,0,0,0,0,0,0,0,0,0,0,0,0,0,0,0,0,0,0,0,NA,NA,NA,NA
"327","6","3",0,1,3,0,2,25,1,0,1,2,23,2,1,0,0,0,33,31,64,0,48,0,75,48.4375,51.5625
"328","6","4",0,0,2,0,2,40,3,2,0,2,40,5,0,6,2,2,50,59,109,2,80,1.8348623853211,73.394495412844,54.1284403669725,45.8715596330275
"329","6","5",0,0,1,0,0,94,3,4,0,0,93,7,0,7,4,2,103,115,218,2,187,0.917431192660551,85.7798165137615,52.7522935779817,47.2477064220183
"330","6","6",0,0,1,0,1,51,3,2,0,1,52,5,0,6,2,0,60,67,127,0,103,0,81.1023622047244,52.755905511811,47.244094488189
"331","60","1",0,0,0,0,0,0,0,0,0,0,0,0,0,0,0,0,0,0,0,0,0,NA,NA,NA,NA
"332","60","2",0,0,1,0,1,1,0,1,0,1,1,1,0,1,1,1,6,7,13,1,2,7.69230769230769,15.3846153846154,53.8461538461538,46.1538461538462
"333","60","3",0,1,0,1,1,1,0,0,1,0,2,0,0,1,0,0,5,6,11,0,3,0,27.2727272727273,54.5454545454545,45.4545454545455
"334","60","4",0,0,0,0,0,0,0,0,0,0,0,0,0,0,0,0,0,0,0,0,0,NA,NA,NA,NA
"335","60","5",0,0,0,0,0,0,0,0,0,0,0,0,0,0,0,0,0,0,0,0,0,NA,NA,NA,NA
"336","60","6",0,0,0,0,0,0,0,0,0,0,0,0,0,0,0,0,0,0,0,0,0,NA,NA,NA,NA
"337","61","1",0,1,2,2,2,3,4,7,1,4,3,8,3,8,7,20,23,55,78,20,6,25.6410256410256,7.69230769230769,70.5128205128205,29.4871794871795
"338","61","2",0,1,3,2,4,10,7,3,1,4,12,8,1,10,4,4,32,45,77,4,22,5.19480519480519,28.5714285714286,58.4415584415584,41.5584415584416
"339","61","3",3,4,6,3,5,18,4,3,4,5,17,4,4,3,3,1,49,41,90,4,35,4.44444444444444,38.8888888888889,45.5555555555556,54.4444444444444
"340","61","4",1,1,3,5,2,10,5,7,1,7,9,8,6,6,7,14,35,60,95,15,19,15.7894736842105,20,63.1578947368421,36.8421052631579
"341","61","5",0,0,2,2,2,4,5,10,0,4,4,13,2,13,10,49,25,98,123,49,8,39.8373983739837,6.50406504065041,79.6747967479675,20.3252032520325
"342","61","6",0,0,2,4,0,5,3,10,0,6,3,10,6,8,11,45,25,91,116,45,8,38.7931034482759,6.89655172413793,78.448275862069,21.551724137931
"343","62","1",1,3,2,6,3,3,6,5,3,6,4,5,6,5,5,32,31,67,98,33,7,33.6734693877551,7.14285714285714,68.3673469387755,31.6326530612245
"344","62","2",1,4,3,5,4,1,5,4,4,4,1,4,4,4,3,4,27,31,58,5,2,8.62068965517241,3.44827586206897,53.448275862069,46.551724137931
"345","62","3",0,0,1,2,1,1,1,4,0,3,1,3,2,3,4,4,12,21,33,4,2,12.1212121212121,6.06060606060606,63.6363636363636,36.3636363636364
"346","62","4",0,0,0,0,0,0,0,2,0,0,0,2,0,1,2,1,3,8,11,1,0,9.09090909090909,0,72.7272727272727,27.2727272727273
"347","62","5",3,1,0,1,1,1,1,0,2,0,2,0,1,1,0,0,11,6,17,3,3,17.6470588235294,17.6470588235294,35.2941176470588,64.7058823529412
"348","62","6",0,0,0,1,0,0,0,1,0,0,0,0,0,1,1,2,3,6,9,2,0,22.2222222222222,0,66.6666666666667,33.3333333333333
"349","63","1",9,2,5,1,4,5,2,1,1,4,5,2,1,2,1,0,31,17,48,9,10,18.75,20.8333333333333,35.4166666666667,64.5833333333333
"350","63","2",62,10,11,1,11,3,1,0,10,2,3,0,1,0,0,0,102,16,118,62,6,52.5423728813559,5.08474576271186,13.5593220338983,86.4406779661017
"351","63","3",43,4,5,1,5,2,2,0,4,2,2,1,1,1,0,0,65,11,76,43,4,56.5789473684211,5.26315789473684,14.4736842105263,85.5263157894737
"352","63","4",10,2,2,0,2,0,0,0,2,0,0,0,0,0,0,0,19,2,21,10,0,47.6190476190476,0,9.52380952380952,90.4761904761905
"353","63","5",4,2,1,1,1,0,0,0,1,0,0,0,0,0,0,0,10,3,13,4,0,30.7692307692308,0,23.0769230769231,76.9230769230769
"354","63","6",0,1,2,0,1,0,0,0,0,1,0,0,0,0,0,0,6,2,8,0,0,0,0,25,75
"355","64","1",3,3,1,2,2,0,0,1,2,0,1,0,0,1,1,2,13,9,22,5,1,22.7272727272727,4.54545454545455,40.9090909090909,59.0909090909091
"356","64","2",0,0,0,0,0,0,0,0,0,0,0,0,0,0,0,0,2,1,3,0,0,0,0,33.3333333333333,66.6666666666667
"357","64","3",0,0,0,1,0,0,1,0,0,1,1,0,0,1,0,0,4,4,8,0,1,0,12.5,50,50
"358","64","4",0,0,0,0,0,0,0,0,0,0,0,0,0,0,0,0,1,0,1,0,0,0,0,0,100
"359","64","5",0,0,0,0,0,0,0,0,0,0,0,0,0,0,0,0,1,1,2,0,0,0,0,50,50
"360","64","6",0,0,0,0,0,0,0,0,0,0,0,0,0,0,0,0,0,0,0,0,0,NA,NA,NA,NA
"361","65","1",3,5,7,9,9,10,7,6,5,10,12,5,6,7,6,8,57,61,118,11,22,9.32203389830508,18.6440677966102,51.6949152542373,48.3050847457627
"362","65","2",1,1,4,1,3,14,3,1,1,4,13,4,2,2,1,1,29,30,59,2,27,3.38983050847458,45.7627118644068,50.8474576271186,49.1525423728814
"363","65","3",0,0,0,2,0,1,1,2,0,2,1,2,2,2,3,6,7,20,27,6,2,22.2222222222222,7.40740740740741,74.0740740740741,25.9259259259259
"364","65","4",0,1,1,1,1,1,0,1,1,1,2,0,1,1,1,0,8,8,16,0,3,0,18.75,50,50
"365","65","5",0,1,0,1,0,2,1,1,0,0,2,1,0,2,1,0,7,8,15,0,4,0,26.6666666666667,53.3333333333333,46.6666666666667
"366","65","6",2,1,0,1,1,0,1,1,1,0,1,1,0,1,1,1,8,8,16,3,1,18.75,6.25,50,50
"367","66","1",0,1,2,0,1,3,2,1,1,1,2,2,2,1,1,1,12,12,24,1,5,4.16666666666667,20.8333333333333,50,50
"368","66","2",17,1,1,0,1,0,0,0,2,0,0,0,1,0,1,0,23,4,27,17,0,62.962962962963,0,14.8148148148148,85.1851851851852
"369","66","3",31,5,6,0,6,0,0,0,5,1,0,0,0,0,0,0,51,6,57,31,0,54.3859649122807,0,10.5263157894737,89.4736842105263
"370","66","4",52,3,3,0,3,0,0,0,3,0,0,0,0,0,0,0,64,3,67,52,0,77.6119402985075,0,4.47761194029851,95.5223880597015
"371","66","5",63,6,6,0,6,0,0,0,6,0,0,0,1,0,0,0,83,8,91,63,0,69.2307692307692,0,8.79120879120879,91.2087912087912
"372","66","6",20,2,2,0,2,0,0,0,2,0,0,0,0,0,0,0,29,2,31,20,0,64.5161290322581,0,6.45161290322581,93.5483870967742
"373","67","1",4,2,0,2,1,0,1,1,1,0,1,1,0,2,1,2,12,10,22,6,1,27.2727272727273,4.54545454545455,45.4545454545455,54.5454545454545
"374","67","2",0,0,0,0,0,0,0,3,0,0,0,3,0,3,3,3,3,15,18,3,0,16.6666666666667,0,83.3333333333333,16.6666666666667
"375","67","3",0,0,0,0,0,0,0,0,0,0,0,0,0,0,0,0,2,1,3,0,0,0,0,33.3333333333333,66.6666666666667
"376","67","4",1,0,0,1,0,0,0,1,1,1,0,0,2,0,2,2,6,8,14,3,0,21.4285714285714,0,57.1428571428571,42.8571428571429
"377","67","5",1,2,1,1,1,0,0,0,1,0,0,0,0,0,0,0,7,3,10,1,0,10,0,30,70
"378","67","6",0,0,0,0,0,0,0,0,0,0,0,0,0,0,0,0,2,0,2,0,0,0,0,0,100
"379","68","1",0,0,0,1,0,0,1,0,0,0,1,0,0,1,0,0,4,3,7,0,1,0,14.2857142857143,42.8571428571429,57.1428571428571
"380","68","2",0,0,0,0,1,0,0,0,0,0,0,0,0,0,0,0,3,1,4,0,0,0,0,25,75
"381","68","3",0,0,0,0,0,0,0,0,0,0,0,0,0,0,0,0,0,0,0,0,0,NA,NA,NA,NA
"382","68","4",0,0,0,0,0,0,0,0,0,0,0,0,0,0,0,0,0,0,0,0,0,NA,NA,NA,NA
"383","68","5",0,0,0,0,0,0,0,0,0,0,0,0,0,0,0,0,0,0,0,0,0,NA,NA,NA,NA
"384","68","6",0,0,0,0,0,0,0,0,0,0,0,0,0,0,0,0,0,0,0,0,0,NA,NA,NA,NA
"385","69","1",0,0,1,0,1,1,1,0,0,1,1,1,0,1,0,0,6,5,11,0,2,0,18.1818181818182,45.4545454545455,54.5454545454545
"386","69","2",2,2,1,2,0,4,1,5,2,1,3,4,3,3,5,5,17,29,46,7,7,15.2173913043478,15.2173913043478,63.0434782608696,36.9565217391304
"387","69","3",0,0,0,1,0,0,0,3,0,1,0,2,1,2,2,32,4,43,47,32,0,68.0851063829787,0,91.4893617021277,8.51063829787234
"388","69","4",0,0,0,0,0,1,0,2,0,0,1,2,0,3,3,21,4,32,36,21,2,58.3333333333333,5.55555555555556,88.8888888888889,11.1111111111111
"389","69","5",0,0,0,1,0,0,0,3,0,1,0,3,1,3,4,13,5,27,32,13,0,40.625,0,84.375,15.625
"390","69","6",0,0,0,1,0,0,0,1,0,1,0,0,1,0,1,14,2,20,22,14,0,63.6363636363636,0,90.9090909090909,9.09090909090909
"391","7","1",4,5,6,8,6,10,8,12,5,9,10,11,8,11,12,12,60,80,140,16,20,11.4285714285714,14.2857142857143,57.1428571428571,42.8571428571429
"392","7","2",1,1,1,4,2,3,5,12,1,4,5,13,3,14,12,26,31,79,110,27,8,24.5454545454545,7.27272727272727,71.8181818181818,28.1818181818182
"393","7","3",5,7,9,4,9,9,6,3,7,6,10,5,4,5,3,4,54,45,99,9,19,9.09090909090909,19.1919191919192,45.4545454545455,54.5454545454545
"394","7","4",5,3,5,6,6,13,5,8,2,8,14,7,4,8,7,16,51,69,120,21,27,17.5,22.5,57.5,42.5
"395","7","5",0,4,7,4,5,16,9,9,4,7,14,14,7,12,10,7,56,76,132,7,30,5.3030303030303,22.7272727272727,57.5757575757576,42.4242424242424
"396","7","6",3,3,10,3,9,8,7,5,3,10,7,9,4,9,5,2,49,51,100,5,15,5,15,51,49
"397","70","1",0,0,0,0,0,1,0,0,0,0,0,1,0,0,0,0,2,3,5,0,1,0,20,60,40
"398","70","2",0,0,0,0,0,0,0,0,0,0,0,0,0,0,0,0,2,1,3,0,0,0,0,33.3333333333333,66.6666666666667
"399","70","3",0,0,0,0,0,0,0,0,0,0,0,0,0,0,0,0,0,0,0,0,0,NA,NA,NA,NA
"400","70","4",0,0,0,0,0,0,0,0,0,0,0,0,0,0,0,0,0,0,0,0,0,NA,NA,NA,NA
"401","70","5",0,0,0,0,0,0,0,0,0,0,0,0,0,0,0,0,0,0,0,0,0,NA,NA,NA,NA
"402","70","6",0,0,0,0,0,0,0,0,0,0,0,0,0,0,0,0,0,0,0,0,0,NA,NA,NA,NA
"403","71","1",3,4,8,2,8,8,4,2,5,6,8,4,2,4,2,0,42,31,73,3,16,4.10958904109589,21.9178082191781,42.4657534246575,57.5342465753425
"404","71","2",3,1,3,3,3,5,4,2,1,5,5,3,3,3,2,2,25,26,51,5,10,9.80392156862745,19.6078431372549,50.9803921568627,49.0196078431373
"405","71","3",0,1,2,2,1,5,3,3,1,3,4,4,2,3,2,8,17,30,47,8,9,17.0212765957447,19.1489361702128,63.8297872340426,36.1702127659574
"406","71","4",1,2,3,2,2,3,1,1,2,3,2,0,3,0,2,2,16,16,32,3,5,9.375,15.625,50,50
"407","71","5",2,1,2,1,2,4,1,2,1,2,4,1,1,2,2,1,16,16,32,3,8,9.375,25,50,50
"408","71","6",0,0,0,0,0,0,0,1,0,0,0,1,0,0,1,0,2,4,6,0,0,0,0,66.6666666666667,33.3333333333333
"409","72","1",0,2,3,1,3,3,1,2,3,2,2,2,2,1,2,0,18,14,32,0,5,0,15.625,43.75,56.25
"410","72","2",6,4,6,1,6,3,1,0,4,3,3,0,2,0,0,0,29,13,42,6,6,14.2857142857143,14.2857142857143,30.952380952381,69.0476190476191
"411","72","3",22,8,8,2,7,5,3,0,7,2,4,1,3,0,0,0,57,18,75,22,9,29.3333333333333,12,24,76
"412","72","4",13,7,8,2,8,4,2,1,6,3,4,1,1,1,1,0,46,19,65,13,8,20,12.3076923076923,29.2307692307692,70.7692307692308
"413","72","5",10,4,2,2,4,8,2,0,3,0,10,0,0,2,0,0,34,16,50,10,18,20,36,32,68
"414","72","6",1,3,5,4,6,4,3,2,3,6,5,1,3,1,2,4,29,27,56,5,9,8.92857142857143,16.0714285714286,48.2142857142857,51.7857142857143
"415","73","1",0,0,0,3,1,2,3,2,1,3,3,2,3,2,2,4,14,20,34,4,5,11.7647058823529,14.7058823529412,58.8235294117647,41.1764705882353
"416","73","2",34,4,4,1,3,4,1,1,3,1,3,1,1,1,1,0,53,13,66,34,7,51.5151515151515,10.6060606060606,19.6969696969697,80.3030303030303
"417","73","3",6,6,4,4,1,6,9,0,5,2,3,5,6,3,0,0,37,26,63,6,9,9.52380952380952,14.2857142857143,41.2698412698413,58.7301587301587
"418","73","4",1,5,6,1,5,5,3,3,6,1,4,5,2,4,3,0,32,25,57,1,9,1.75438596491228,15.7894736842105,43.859649122807,56.140350877193
"419","73","5",6,3,4,2,5,1,2,1,3,3,2,1,2,2,1,0,26,15,41,6,3,14.6341463414634,7.31707317073171,36.5853658536585,63.4146341463415
"420","73","6",1,1,0,4,2,2,3,1,1,3,4,0,2,1,0,0,14,14,28,1,6,3.57142857142857,21.4285714285714,50,50
"421","74","1",0,0,0,2,1,1,2,1,0,2,2,1,1,1,1,4,8,14,22,4,3,18.1818181818182,13.6363636363636,63.6363636363636,36.3636363636364
"422","74","2",1,2,1,0,1,5,0,0,1,0,5,0,0,0,0,0,12,7,19,1,10,5.26315789473684,52.6315789473684,36.8421052631579,63.1578947368421
"423","74","3",0,1,2,0,1,3,0,0,1,0,2,0,0,0,0,0,8,5,13,0,5,0,38.4615384615385,38.4615384615385,61.5384615384615
"424","74","4",0,0,0,1,0,0,1,0,0,1,0,0,1,0,0,0,4,3,7,0,0,0,0,42.8571428571429,57.1428571428571
"425","74","5",0,1,1,0,0,10,0,0,0,0,10,0,0,0,0,0,14,11,25,0,20,0,80,44,56
"426","74","6",1,3,2,3,3,4,2,1,2,2,5,0,1,1,0,1,19,15,34,2,9,5.88235294117647,26.4705882352941,44.1176470588235,55.8823529411765
"427","75","1",2,0,2,1,2,2,1,2,1,3,2,2,2,1,2,2,15,15,30,4,4,13.3333333333333,13.3333333333333,50,50
"428","75","2",0,0,0,1,0,1,1,1,0,1,1,1,1,0,1,1,5,8,13,1,2,7.69230769230769,15.3846153846154,61.5384615384615,38.4615384615385
"429","75","3",0,0,0,0,1,0,1,0,1,0,1,1,0,2,0,0,5,5,10,0,1,0,10,50,50
"430","75","4",4,0,0,1,1,1,0,1,1,1,2,0,1,1,1,0,11,7,18,4,3,22.2222222222222,16.6666666666667,38.8888888888889,61.1111111111111
"431","75","5",3,5,6,8,4,2,7,3,5,8,0,2,10,0,3,2,40,31,71,5,2,7.04225352112676,2.8169014084507,43.6619718309859,56.3380281690141
"432","75","6",15,6,6,2,5,1,3,0,6,2,0,1,3,1,0,0,39,15,54,15,1,27.7777777777778,1.85185185185185,27.7777777777778,72.2222222222222
"433","76","1",14,10,12,7,11,10,6,9,10,10,9,8,9,7,9,2,81,65,146,16,19,10.958904109589,13.013698630137,44.5205479452055,55.4794520547945
"434","76","2",0,2,3,4,2,5,4,8,2,4,4,8,5,7,8,12,30,51,81,12,9,14.8148148148148,11.1111111111111,62.962962962963,37.037037037037
"435","76","3",67,20,21,1,22,2,1,0,21,2,2,0,1,0,0,0,137,26,163,67,4,41.1042944785276,2.45398773006135,15.9509202453988,84.0490797546012
"436","76","4",73,13,12,4,11,2,3,1,12,3,2,0,4,0,1,1,121,24,145,74,4,51.0344827586207,2.75862068965517,16.551724137931,83.448275862069
"437","76","5",44,11,14,3,13,6,6,0,12,6,5,3,5,1,0,0,100,32,132,44,11,33.3333333333333,8.33333333333333,24.2424242424242,75.7575757575758
"438","76","6",45,14,16,3,16,6,3,0,14,5,6,0,3,0,0,0,106,28,134,45,12,33.5820895522388,8.95522388059701,20.8955223880597,79.1044776119403
"439","77","1",4,4,3,2,3,7,2,3,4,1,6,3,2,2,3,0,29,23,52,4,13,7.69230769230769,25,44.2307692307692,55.7692307692308
"440","77","2",3,1,0,2,1,0,2,0,0,1,1,0,1,1,0,0,11,5,16,3,1,18.75,6.25,31.25,68.75
"441","77","3",0,0,0,0,0,0,0,0,0,0,0,0,0,0,0,0,2,0,2,0,0,0,0,0,100
"442","77","4",0,0,0,0,0,0,0,0,0,0,0,0,0,0,0,0,0,0,0,0,0,NA,NA,NA,NA
"443","77","5",0,0,0,0,0,0,0,0,0,0,0,0,0,0,0,0,0,0,0,0,0,NA,NA,NA,NA
"444","77","6",0,0,0,0,0,0,0,0,0,0,0,0,0,0,0,0,0,0,0,0,0,NA,NA,NA,NA
"445","78","1",0,0,0,0,0,3,0,1,0,0,3,1,0,1,1,0,5,8,13,0,6,0,46.1538461538462,61.5384615384615,38.4615384615385
"446","78","2",0,0,0,0,0,0,0,0,0,0,0,0,0,0,0,0,1,1,2,0,0,0,0,50,50
"447","78","3",0,0,0,0,0,0,0,0,0,0,0,0,0,0,0,0,0,0,0,0,0,NA,NA,NA,NA
"448","78","4",0,0,0,0,0,0,0,0,0,0,0,0,0,0,0,0,0,0,0,0,0,NA,NA,NA,NA
"449","78","5",0,0,0,0,0,0,0,0,0,0,0,0,0,0,0,0,0,0,0,0,0,NA,NA,NA,NA
"450","78","6",0,0,0,0,0,0,0,0,0,0,0,0,0,0,0,0,0,0,0,0,0,NA,NA,NA,NA
"451","79","1",0,2,1,1,1,0,1,0,2,0,0,0,2,0,1,0,8,6,14,0,0,0,0,42.8571428571429,57.1428571428571
"452","79","2",0,0,0,0,0,0,0,0,0,0,0,0,0,0,0,0,0,1,1,0,0,0,0,100,0
"453","79","3",0,0,0,0,0,0,0,0,0,0,0,0,0,0,0,0,0,2,2,0,0,0,0,100,0
"454","79","4",0,0,0,0,0,0,0,0,0,0,0,0,0,0,0,0,0,0,0,0,0,NA,NA,NA,NA
"455","79","5",4,5,5,2,5,6,2,2,5,2,5,2,2,1,1,2,31,23,54,6,11,11.1111111111111,20.3703703703704,42.5925925925926,57.4074074074074
"456","79","6",27,7,8,3,9,5,3,2,7,4,5,2,3,2,2,3,66,29,95,30,10,31.5789473684211,10.5263157894737,30.5263157894737,69.4736842105263
"457","8","1",0,1,1,1,1,0,1,1,1,1,0,1,0,1,0,0,6,7,13,0,0,0,0,53.8461538461538,46.1538461538462
"458","8","2",0,0,0,0,1,1,0,0,0,0,1,0,0,0,0,0,4,2,6,0,2,0,33.3333333333333,33.3333333333333,66.6666666666667
"459","8","3",0,0,0,0,0,0,0,0,0,0,0,0,0,0,0,0,0,0,0,0,0,NA,NA,NA,NA
"460","8","4",0,0,0,0,0,0,0,0,0,0,0,0,0,0,0,0,0,0,0,0,0,NA,NA,NA,NA
"461","8","5",0,0,0,0,0,171,0,0,0,0,171,0,0,0,0,0,172,173,345,0,342,0,99.1304347826087,50.1449275362319,49.8550724637681
"462","8","6",0,0,0,0,0,321,0,0,0,0,321,0,0,0,0,0,323,322,645,0,642,0,99.5348837209302,49.922480620155,50.077519379845
"463","80","1",0,0,1,0,1,1,0,0,0,1,2,0,0,1,0,0,5,5,10,0,3,0,30,50,50
"464","80","2",0,0,0,0,0,0,0,0,0,0,0,0,0,0,0,0,0,1,1,0,0,0,0,100,0
"465","80","3",0,0,0,0,0,0,0,0,0,0,0,0,0,0,0,0,0,0,0,0,0,NA,NA,NA,NA
"466","80","4",0,0,0,0,0,0,0,0,0,0,0,0,0,0,0,0,0,1,1,0,0,0,0,100,0
"467","80","5",0,0,0,0,0,0,0,0,0,0,0,0,0,0,0,0,0,0,0,0,0,NA,NA,NA,NA
"468","80","6",0,0,0,0,0,0,0,0,0,0,0,0,0,0,0,0,0,0,0,0,0,NA,NA,NA,NA
"469","81","1",0,0,0,0,0,0,0,0,0,0,0,0,0,0,0,0,0,0,0,0,0,NA,NA,NA,NA
"470","81","2",0,0,0,0,0,0,0,0,0,0,0,0,0,0,0,0,0,0,0,0,0,NA,NA,NA,NA
"471","81","3",0,0,0,0,0,1,0,0,0,0,2,0,0,1,1,0,3,5,8,0,3,0,37.5,62.5,37.5
"472","81","4",2,0,0,0,0,0,0,0,1,0,0,0,0,0,0,0,5,1,6,2,0,33.3333333333333,0,16.6666666666667,83.3333333333333
"473","81","5",0,0,0,0,0,0,0,0,0,0,0,0,0,0,0,0,0,0,0,0,0,NA,NA,NA,NA
"474","81","6",0,0,0,0,0,0,0,0,0,0,0,0,0,0,0,0,1,0,1,0,0,0,0,0,100
"475","82","1",6,1,2,0,2,3,0,0,1,1,2,0,0,0,0,0,15,6,21,6,5,28.5714285714286,23.8095238095238,28.5714285714286,71.4285714285714
"476","82","2",0,0,0,0,0,0,0,0,0,1,0,0,1,0,0,0,2,3,5,0,0,0,0,60,40
"477","82","3",6,1,1,0,0,1,0,0,0,0,0,1,0,0,0,0,10,3,13,6,1,46.1538461538462,7.69230769230769,23.0769230769231,76.9230769230769
"478","82","4",10,2,4,1,4,0,2,0,2,3,0,1,1,1,0,0,26,8,34,10,0,29.4117647058824,0,23.5294117647059,76.4705882352941
"479","82","5",6,4,6,2,5,6,3,0,5,3,5,1,3,0,0,0,35,17,52,6,11,11.5384615384615,21.1538461538462,32.6923076923077,67.3076923076923
"480","82","6",11,2,3,0,3,0,0,0,3,0,0,0,0,0,0,0,22,3,25,11,0,44,0,12,88
"481","83","1",0,1,1,0,0,3,1,2,1,0,1,3,1,2,2,3,9,15,24,3,4,12.5,16.6666666666667,62.5,37.5
"482","83","2",17,4,5,0,4,2,0,0,3,1,1,1,0,0,0,0,33,8,41,17,3,41.4634146341463,7.31707317073171,19.5121951219512,80.4878048780488
"483","83","3",16,2,2,1,2,0,0,1,2,1,0,0,1,0,1,1,26,7,33,17,0,51.5151515151515,0,21.2121212121212,78.7878787878788
"484","83","4",1,1,0,1,1,2,1,0,1,0,3,0,0,1,0,0,10,5,15,1,5,6.66666666666667,33.3333333333333,33.3333333333333,66.6666666666667
"485","83","5",6,2,1,1,1,0,0,1,2,0,0,0,1,0,1,0,15,4,19,6,0,31.5789473684211,0,21.0526315789474,78.9473684210526
"486","83","6",6,2,1,1,1,0,1,0,2,0,0,0,1,0,0,0,15,3,18,6,0,33.3333333333333,0,16.6666666666667,83.3333333333333
"487","84","1",2,6,3,6,5,5,6,4,6,3,6,4,4,5,3,5,37,39,76,7,11,9.21052631578947,14.4736842105263,51.3157894736842,48.6842105263158
"488","84","2",5,7,5,6,2,12,9,3,6,4,9,6,8,4,3,3,50,45,95,8,21,8.42105263157895,22.1052631578947,47.3684210526316,52.6315789473684
"489","84","3",2,2,2,3,0,6,4,6,1,3,4,7,4,5,6,10,26,42,68,12,10,17.6470588235294,14.7058823529412,61.7647058823529,38.2352941176471
"490","84","4",1,1,1,2,0,5,6,9,2,2,4,13,4,11,9,12,28,57,85,13,9,15.2941176470588,10.5882352941176,67.0588235294118,32.9411764705882
"491","84","5",1,3,6,3,5,6,2,6,3,6,5,5,3,5,6,19,33,54,87,20,11,22.9885057471264,12.6436781609195,62.0689655172414,37.9310344827586
"492","84","6",1,3,4,3,4,12,2,3,3,4,12,2,3,3,3,4,33,36,69,5,24,7.2463768115942,34.7826086956522,52.1739130434783,47.8260869565217
"493","85","1",2,2,2,1,1,1,0,1,2,0,0,0,1,0,1,0,11,6,17,2,1,11.7647058823529,5.88235294117647,35.2941176470588,64.7058823529412
"494","85","2",1,1,1,1,0,2,3,2,1,1,1,3,2,2,2,4,12,18,30,5,3,16.6666666666667,10,60,40
"495","85","3",2,3,4,3,2,3,4,4,2,4,2,5,4,4,4,4,27,30,57,6,5,10.5263157894737,8.7719298245614,52.6315789473684,47.3684210526316
"496","85","4",0,0,0,0,0,1,0,1,0,0,0,1,0,1,1,0,3,5,8,0,1,0,12.5,62.5,37.5
"497","85","5",2,1,3,0,2,3,1,2,1,2,2,3,1,2,1,2,14,17,31,4,5,12.9032258064516,16.1290322580645,54.8387096774194,45.1612903225806
"498","85","6",3,1,1,0,1,1,1,2,1,0,1,3,0,2,2,0,11,11,22,3,2,13.6363636363636,9.09090909090909,50,50
"499","86","1",0,1,2,0,1,1,0,0,1,0,0,0,0,0,0,0,6,3,9,0,1,0,11.1111111111111,33.3333333333333,66.6666666666667
"500","86","2",0,0,0,0,0,0,0,0,0,0,0,0,0,0,0,0,0,2,2,0,0,0,0,100,0
"501","86","3",0,0,0,0,0,0,0,0,0,0,0,0,0,0,0,0,0,0,0,0,0,NA,NA,NA,NA
"502","86","4",0,0,0,0,0,0,0,0,0,0,0,0,0,0,0,0,0,1,1,0,0,0,0,100,0
"503","86","5",0,0,0,0,0,0,0,0,0,0,0,0,0,0,0,0,1,0,1,0,0,0,0,0,100
"504","86","6",0,0,0,0,0,0,0,0,0,0,0,0,0,0,0,0,1,1,2,0,0,0,0,50,50
"505","87","1",13,8,12,6,10,11,10,3,8,10,10,7,7,6,3,0,75,52,127,13,21,10.2362204724409,16.5354330708661,40.9448818897638,59.0551181102362
"506","87","2",11,5,4,6,5,8,3,6,5,4,9,3,5,4,6,2,50,39,89,13,17,14.6067415730337,19.1011235955056,43.8202247191011,56.1797752808989
"507","87","3",9,6,6,3,7,2,4,1,5,3,4,2,1,4,1,0,40,21,61,9,6,14.7540983606557,9.83606557377049,34.4262295081967,65.5737704918033
"508","87","4",3,0,4,1,4,15,1,1,1,4,15,1,1,1,1,1,32,25,57,4,30,7.01754385964912,52.6315789473684,43.859649122807,56.140350877193
"509","87","5",2,4,3,2,3,5,0,4,3,1,5,2,1,2,3,2,23,22,45,4,10,8.88888888888889,22.2222222222222,48.8888888888889,51.1111111111111
"510","87","6",11,7,9,2,10,1,2,0,8,4,2,0,1,1,0,0,45,16,61,11,3,18.0327868852459,4.91803278688525,26.2295081967213,73.7704918032787
"511","88","1",5,1,0,1,1,2,0,1,2,0,3,0,1,1,1,1,14,9,23,6,5,26.0869565217391,21.7391304347826,39.1304347826087,60.8695652173913
"512","88","2",0,0,0,0,1,0,0,0,0,0,0,0,0,0,0,0,3,1,4,0,0,0,0,25,75
"513","88","3",0,0,0,0,0,0,0,0,0,0,0,0,0,0,0,0,0,0,0,0,0,NA,NA,NA,NA
"514","88","4",0,0,0,0,0,0,0,0,0,0,0,0,0,0,0,0,0,0,0,0,0,NA,NA,NA,NA
"515","88","5",0,0,0,0,0,0,0,0,0,0,0,0,0,0,0,0,0,0,0,0,0,NA,NA,NA,NA
"516","88","6",0,0,0,0,0,0,0,0,0,0,0,0,0,0,0,0,0,0,0,0,0,NA,NA,NA,NA
"517","9","1",1,7,8,1,7,3,1,1,6,2,2,1,1,0,1,2,30,17,47,3,5,6.38297872340426,10.6382978723404,36.1702127659574,63.8297872340426
"518","9","2",8,6,9,2,10,5,4,3,6,5,6,5,2,5,3,2,49,35,84,10,11,11.9047619047619,13.0952380952381,41.6666666666667,58.3333333333333
"519","9","3",26,26,30,6,29,38,5,5,27,9,37,4,7,3,5,0,168,92,260,26,75,10,28.8461538461538,35.3846153846154,64.6153846153846
"520","9","4",4,38,71,0,71,229,2,2,38,33,229,4,0,4,2,0,419,311,730,4,458,0.547945205479452,62.7397260273973,42.6027397260274,57.3972602739726
"521","9","5",1,34,69,0,69,231,2,0,34,35,231,2,0,2,0,0,408,305,713,1,462,0.140252454417952,64.796633941094,42.7769985974755,57.2230014025245
"522","9","6",2,30,64,0,63,274,5,0,30,33,273,5,0,5,0,0,439,348,787,2,547,0.254129606099111,69.5044472681067,44.2185514612452,55.7814485387548
"523","90","1",7,3,2,3,0,2,4,1,3,2,0,2,4,0,1,0,23,14,37,7,2,18.9189189189189,5.40540540540541,37.8378378378378,62.1621621621622
"524","90","2",0,1,2,0,2,0,0,1,1,1,0,1,1,1,2,3,8,11,19,3,0,15.7894736842105,0,57.8947368421053,42.1052631578947
"525","90","3",5,2,1,1,1,1,1,0,2,0,1,0,1,0,0,0,14,5,19,5,2,26.3157894736842,10.5263157894737,26.3157894736842,73.6842105263158
"526","90","4",1,1,0,1,1,0,0,1,0,1,1,0,0,1,1,0,7,5,12,1,1,8.33333333333333,8.33333333333333,41.6666666666667,58.3333333333333
"527","90","5",0,0,0,0,1,0,0,0,0,1,1,0,0,0,0,0,3,3,6,0,1,0,16.6666666666667,50,50
"528","90","6",3,0,0,0,0,0,0,0,0,0,0,0,0,0,0,0,6,0,6,3,0,50,0,0,100
"529","91","1",0,1,0,1,1,0,1,1,1,0,1,1,1,2,1,2,7,10,17,2,1,11.7647058823529,5.88235294117647,58.8235294117647,41.1764705882353
"530","91","2",0,0,0,0,0,0,0,2,0,0,0,2,0,1,1,4,2,11,13,4,0,30.7692307692308,0,84.6153846153846,15.3846153846154
"531","91","3",0,0,0,2,0,2,2,2,0,2,2,3,2,3,3,4,9,21,30,4,4,13.3333333333333,13.3333333333333,70,30
"532","91","4",0,0,1,0,0,3,1,3,0,1,2,4,1,2,2,2,8,17,25,2,5,8,20,68,32
"533","91","5",0,0,0,0,0,0,0,1,0,0,0,2,0,1,1,1,2,7,9,1,0,11.1111111111111,0,77.7777777777778,22.2222222222222
"534","91","6",0,0,0,0,0,0,0,1,0,0,0,1,0,1,2,7,2,13,15,7,0,46.6666666666667,0,86.6666666666667,13.3333333333333
"535","93","1",1,2,3,0,3,3,0,1,2,1,3,1,0,1,1,2,14,13,27,3,6,11.1111111111111,22.2222222222222,48.1481481481481,51.8518518518519
"536","93","2",15,2,2,4,4,4,3,2,3,4,6,1,3,3,3,2,39,25,64,17,10,26.5625,15.625,39.0625,60.9375
"537","93","3",35,7,5,2,6,1,3,0,7,0,2,1,1,2,0,0,62,13,75,35,3,46.6666666666667,4,17.3333333333333,82.6666666666667
"538","93","4",23,8,5,4,5,2,3,1,7,1,2,0,4,0,1,2,53,18,71,25,4,35.2112676056338,5.63380281690141,25.3521126760563,74.6478873239437
"539","93","5",19,7,5,2,6,1,2,0,8,0,1,0,2,0,0,0,45,11,56,19,2,33.9285714285714,3.57142857142857,19.6428571428571,80.3571428571429
"540","93","6",14,4,5,1,6,4,0,2,4,2,6,1,0,2,2,2,38,20,58,16,10,27.5862068965517,17.2413793103448,34.4827586206897,65.5172413793103
"541","94","1",0,0,1,0,0,1,0,0,0,0,1,0,0,0,0,0,4,2,6,0,2,0,33.3333333333333,33.3333333333333,66.6666666666667
"542","94","2",4,1,3,5,4,6,6,4,1,7,8,5,4,7,4,8,35,45,80,12,14,15,17.5,56.25,43.75
"543","94","3",1,2,4,3,3,3,3,5,2,5,2,6,4,4,5,12,25,42,67,13,5,19.4029850746269,7.46268656716418,62.6865671641791,37.3134328358209
"544","94","4",2,2,2,1,4,2,1,5,2,1,3,5,0,6,5,10,21,33,54,12,5,22.2222222222222,9.25925925925926,61.1111111111111,38.8888888888889
"545","94","5",9,4,3,3,5,3,5,1,4,3,5,3,2,5,1,1,35,25,60,10,8,16.6666666666667,13.3333333333333,41.6666666666667,58.3333333333333
"546","94","6",2,1,2,0,1,8,3,4,1,1,7,8,0,7,4,2,22,32,54,4,15,7.40740740740741,27.7777777777778,59.2592592592593,40.7407407407407
