"","fish_id","bin","LLLL","LLLR","LLRL","LLRR","LRLL","LRLR","LRRL","LRRR","RLLL","RLLR","RLRL","RLRR","RRLL","RRLR","RRRL","RRRR","L","R","total_turns","reps","alts","rel_reps","rel_alts","rel_R","rel_L"
"1","1","1",0,0,0,1,2,0,2,0,0,2,2,1,0,3,1,6,7,16,23,6,2,26.0869565217391,8.69565217391304,69.5652173913043,30.4347826086957
"2","1","2",8,6,5,7,7,15,7,5,6,6,18,4,5,7,5,4,62,56,118,12,33,10.1694915254237,27.9661016949153,47.4576271186441,52.5423728813559
"3","1","3",3,2,3,5,5,11,7,7,2,6,13,9,3,11,7,5,45,57,102,8,24,7.84313725490196,23.5294117647059,55.8823529411765,44.1176470588235
"4","1","4",4,3,5,4,4,7,7,4,3,6,6,7,4,6,4,1,39,39,78,5,13,6.41025641025641,16.6666666666667,50,50
"5","1","5",7,4,7,7,4,7,6,5,4,10,4,4,10,1,5,3,48,43,91,10,11,10.989010989011,12.0879120879121,47.2527472527473,52.7472527472527
"6","1","6",10,7,7,5,7,1,4,3,7,4,1,2,4,3,3,2,45,28,73,12,2,16.4383561643836,2.73972602739726,38.3561643835616,61.6438356164384
"7","10","1",1,1,0,4,1,5,6,10,1,3,5,12,3,13,10,13,29,62,91,14,10,15.3846153846154,10.989010989011,68.1318681318681,31.8681318681319
"8","10","2",0,1,1,1,1,7,6,9,1,1,7,14,1,15,10,31,27,82,109,31,14,28.4403669724771,12.8440366972477,75.2293577981651,24.7706422018349
"9","10","3",0,1,1,4,1,3,2,11,1,4,3,9,4,9,10,33,23,76,99,33,6,33.3333333333333,6.06060606060606,76.7676767676768,23.2323232323232
"10","10","4",0,0,0,0,0,1,0,4,0,0,2,4,0,5,5,57,7,74,81,57,3,70.3703703703704,3.7037037037037,91.358024691358,8.64197530864197
"11","10","5",0,0,1,1,0,5,1,5,0,2,3,5,2,3,4,35,13,57,70,35,8,50,11.4285714285714,81.4285714285714,18.5714285714286
"12","10","6",0,0,0,0,0,0,0,3,0,0,0,3,0,3,2,41,3,52,55,41,0,74.5454545454545,0,94.5454545454545,5.45454545454545
"13","11","1",12,10,12,4,12,7,6,2,10,6,7,4,4,5,2,2,66,42,108,14,14,12.962962962963,12.962962962963,38.8888888888889,61.1111111111111
"14","11","2",2,4,4,6,6,6,4,6,4,6,7,4,5,5,6,10,40,48,88,12,13,13.6363636363636,14.7727272727273,54.5454545454545,45.4545454545455
"15","11","3",15,3,5,2,5,8,4,4,4,4,8,6,3,6,5,3,49,39,88,18,16,20.4545454545455,18.1818181818182,44.3181818181818,55.6818181818182
"16","11","4",8,6,7,6,7,9,7,5,5,8,9,6,6,6,5,3,57,49,106,11,18,10.377358490566,16.9811320754717,46.2264150943396,53.7735849056604
"17","11","5",1,3,3,7,4,6,7,7,3,7,7,6,6,7,7,2,39,47,86,3,13,3.48837209302326,15.1162790697674,54.6511627906977,45.3488372093023
"18","11","6",0,2,4,2,2,11,6,5,2,4,9,9,4,7,5,8,32,51,83,8,20,9.63855421686747,24.0963855421687,61.4457831325301,38.5542168674699
"19","12","1",1,1,1,1,0,1,0,2,0,1,1,1,1,1,2,4,9,12,21,5,2,23.8095238095238,9.52380952380952,57.1428571428571,42.8571428571429
"20","12","2",0,0,0,1,0,0,0,1,0,1,0,0,0,0,0,1,2,5,7,1,0,14.2857142857143,0,71.4285714285714,28.5714285714286
"21","12","3",17,1,1,0,1,0,1,0,2,0,0,0,1,0,0,0,24,3,27,17,0,62.962962962963,0,11.1111111111111,88.8888888888889
"22","12","4",12,2,2,0,1,2,0,0,2,0,1,0,1,0,0,0,20,6,26,12,3,46.1538461538462,11.5384615384615,23.0769230769231,76.9230769230769
"23","12","5",5,1,0,0,1,1,0,0,1,0,2,0,0,1,0,0,10,5,15,5,3,33.3333333333333,20,33.3333333333333,66.6666666666667
"24","12","6",0,0,1,2,4,2,1,1,0,3,5,0,0,3,2,1,13,15,28,1,7,3.57142857142857,25,53.5714285714286,46.4285714285714
"25","13","1",0,1,1,3,3,9,7,4,1,3,11,8,0,10,4,7,29,46,75,7,20,9.33333333333333,26.6666666666667,61.3333333333333,38.6666666666667
"26","13","2",3,4,6,3,7,7,3,3,3,5,8,3,1,4,2,4,36,33,69,7,15,10.1449275362319,21.7391304347826,47.8260869565217,52.1739130434783
"27","13","3",4,5,7,3,4,6,6,6,5,5,2,9,6,5,6,9,42,49,91,13,8,14.2857142857143,8.79120879120879,53.8461538461538,46.1538461538462
"28","13","4",4,7,3,6,4,4,5,2,6,2,5,2,4,3,2,0,36,26,62,4,9,6.45161290322581,14.5161290322581,41.9354838709677,58.0645161290323
"29","13","5",2,4,2,4,2,2,2,3,3,2,2,1,4,1,3,2,23,19,42,4,4,9.52380952380952,9.52380952380952,45.2380952380952,54.7619047619048
"30","13","6",1,3,3,3,3,1,3,0,3,3,2,0,3,1,0,0,19,13,32,1,3,3.125,9.375,40.625,59.375
"31","14","1",7,5,10,1,8,10,3,1,5,6,8,3,3,1,1,0,48,27,75,7,18,9.33333333333333,24,36,64
"32","14","2",0,0,0,0,1,0,0,0,0,0,0,0,0,0,0,0,3,1,4,0,0,0,0,25,75
"33","14","3",0,0,0,0,0,0,0,0,0,0,0,0,0,0,0,0,0,1,1,0,0,0,0,100,0
"34","14","4",0,0,0,0,0,0,0,0,0,0,1,0,0,0,0,0,2,2,4,0,1,0,25,50,50
"35","14","5",0,0,0,0,0,0,0,0,0,0,0,0,0,0,0,0,0,0,0,0,0,NA,NA,NA,NA
"36","14","6",0,0,0,0,0,0,0,0,0,0,0,0,0,0,0,0,0,1,1,0,0,0,0,100,0
"37","15","1",7,7,6,7,7,1,10,3,7,6,2,5,6,6,2,11,48,48,96,18,3,18.75,3.125,50,50
"38","15","2",15,7,4,6,3,10,7,3,7,3,8,4,7,3,3,4,56,41,97,19,18,19.5876288659794,18.5567010309278,42.2680412371134,57.7319587628866
"39","15","3",6,2,4,2,2,3,3,0,2,4,1,1,4,0,0,0,23,14,37,6,4,16.2162162162162,10.8108108108108,37.8378378378378,62.1621621621622
"40","15","4",0,3,4,3,6,1,2,4,3,4,3,3,1,4,4,3,24,27,51,3,4,5.88235294117647,7.84313725490196,52.9411764705882,47.0588235294118
"41","15","5",4,6,6,6,5,6,6,3,7,6,4,3,8,1,3,2,45,34,79,6,10,7.59493670886076,12.6582278481013,43.0379746835443,56.9620253164557
"42","15","6",3,5,9,4,8,9,8,1,5,8,7,5,6,3,1,2,49,38,87,5,16,5.74712643678161,18.3908045977011,43.6781609195402,56.3218390804598
"43","16","1",0,1,2,2,3,6,2,6,1,3,7,6,1,6,5,10,22,42,64,10,13,15.625,20.3125,65.625,34.375
"44","16","2",3,4,4,6,4,9,3,7,4,6,9,4,6,4,6,5,40,47,87,8,18,9.19540229885057,20.6896551724138,54.0229885057471,45.9770114942529
"45","16","3",4,3,6,1,3,8,4,4,3,3,5,7,3,5,4,0,34,32,66,4,13,6.06060606060606,19.6969696969697,48.4848484848485,51.5151515151515
"46","16","4",0,2,1,3,1,5,6,5,2,2,5,8,3,8,5,25,23,61,84,25,10,29.7619047619048,11.9047619047619,72.6190476190476,27.3809523809524
"47","16","5",0,1,4,2,3,7,5,4,1,5,6,7,3,6,4,3,28,36,64,3,13,4.6875,20.3125,56.25,43.75
"48","16","6",10,7,13,0,13,6,0,0,6,6,6,0,0,0,0,0,51,19,70,10,12,14.2857142857143,17.1428571428571,27.1428571428571,72.8571428571429
"49","17","1",0,0,1,2,1,8,4,4,0,3,9,6,2,7,4,20,22,52,74,20,17,27.027027027027,22.972972972973,70.2702702702703,29.7297297297297
"50","17","2",54,8,7,1,7,9,2,1,8,0,9,1,1,2,1,0,90,24,114,54,18,47.3684210526316,15.7894736842105,21.0526315789474,78.9473684210526
"51","17","3",36,12,11,3,8,10,6,0,12,1,7,4,5,1,0,0,87,32,119,36,17,30.2521008403361,14.2857142857143,26.890756302521,73.109243697479
"52","17","4",11,5,7,5,8,12,6,4,5,7,13,5,5,6,4,8,60,54,114,19,25,16.6666666666667,21.9298245614035,47.3684210526316,52.6315789473684
"53","17","5",2,6,5,2,6,1,3,3,6,1,2,4,1,5,3,3,29,27,56,5,3,8.92857142857143,5.35714285714286,48.2142857142857,51.7857142857143
"54","17","6",7,6,5,4,5,4,1,6,6,3,3,3,4,2,6,5,39,34,73,12,7,16.4383561643836,9.58904109589041,46.5753424657534,53.4246575342466
"55","18","1",0,1,4,4,4,16,5,12,1,7,16,12,4,12,11,15,46,81,127,15,32,11.8110236220472,25.1968503937008,63.7795275590551,36.2204724409449
"56","18","2",3,2,6,3,6,11,8,8,2,7,10,13,3,12,7,13,47,70,117,16,21,13.6752136752137,17.9487179487179,59.8290598290598,40.1709401709402
"57","18","3",10,4,5,4,5,16,9,3,4,5,16,8,4,8,3,8,57,58,115,18,32,15.6521739130435,27.8260869565217,50.4347826086956,49.5652173913044
"58","18","4",2,7,9,6,6,5,9,5,7,8,2,8,9,5,6,4,50,51,101,6,7,5.94059405940594,6.93069306930693,50.4950495049505,49.5049504950495
"59","18","5",8,4,6,4,5,9,2,6,4,6,8,4,4,3,6,4,45,41,86,12,17,13.953488372093,19.7674418604651,47.6744186046512,52.3255813953488
"60","18","6",3,5,8,2,6,18,3,2,5,5,16,3,3,1,2,1,48,38,86,4,34,4.65116279069767,39.5348837209302,44.1860465116279,55.8139534883721
"61","19","1",0,2,3,4,2,5,3,4,2,5,5,3,4,3,4,2,25,29,54,2,10,3.7037037037037,18.5185185185185,53.7037037037037,46.2962962962963
"62","19","2",5,5,5,3,5,6,2,7,5,3,5,6,4,5,7,15,40,51,91,20,11,21.978021978022,12.0879120879121,56.043956043956,43.956043956044
"63","19","3",7,5,4,4,6,3,3,2,5,3,5,2,2,4,2,0,35,25,60,7,8,11.6666666666667,13.3333333333333,41.6666666666667,58.3333333333333
"64","19","4",1,2,2,2,0,3,4,6,1,2,1,8,3,6,5,10,20,39,59,11,4,18.6440677966102,6.77966101694915,66.1016949152542,33.8983050847458
"65","19","5",2,2,2,2,1,3,3,3,1,2,3,4,2,4,3,4,20,24,44,6,6,13.6363636363636,13.6363636363636,54.5454545454545,45.4545454545455
"66","19","6",0,0,0,1,1,3,3,4,0,1,3,6,1,6,4,9,14,31,45,9,6,20,13.3333333333333,68.8888888888889,31.1111111111111
"67","2","1",8,9,16,5,15,14,6,6,9,12,13,6,7,5,6,2,81,61,142,10,27,7.04225352112676,19.0140845070423,42.9577464788732,57.0422535211268
"68","2","2",2,5,9,5,10,19,5,7,5,10,20,7,4,8,7,6,64,68,132,8,39,6.06060606060606,29.5454545454545,51.5151515151515,48.4848484848485
"69","2","3",6,4,4,2,2,5,3,0,4,2,4,1,3,0,0,0,28,15,43,6,9,13.953488372093,20.9302325581395,34.8837209302326,65.1162790697674
"70","2","4",1,2,0,3,1,4,2,2,2,1,6,1,2,3,2,0,17,18,35,1,10,2.85714285714286,28.5714285714286,51.4285714285714,48.5714285714286
"71","2","5",4,6,11,3,8,27,5,2,6,7,25,4,5,2,2,1,68,53,121,5,52,4.13223140495868,42.9752066115703,43.801652892562,56.198347107438
"72","2","6",16,8,10,4,10,20,3,1,8,6,20,0,4,0,1,0,74,40,114,16,40,14.0350877192982,35.0877192982456,35.0877192982456,64.9122807017544
"73","20","1",18,6,7,8,8,11,7,4,7,9,11,3,8,3,4,2,72,47,119,20,22,16.8067226890756,18.4873949579832,39.4957983193277,60.5042016806723
"74","20","2",5,11,12,8,13,11,7,3,11,9,12,3,6,4,3,2,71,52,123,7,23,5.69105691056911,18.6991869918699,42.2764227642276,57.7235772357724
"75","20","3",19,6,8,4,7,6,5,2,7,6,4,3,6,1,2,3,60,32,92,22,10,23.9130434782609,10.8695652173913,34.7826086956522,65.2173913043478
"76","20","4",9,3,4,1,3,1,2,0,3,2,1,0,2,0,0,0,25,9,34,9,2,26.4705882352941,5.88235294117647,26.4705882352941,73.5294117647059
"77","20","5",8,1,1,1,2,1,0,1,2,1,2,0,1,1,1,1,18,9,27,9,3,33.3333333333333,11.1111111111111,33.3333333333333,66.6666666666667
"78","20","6",5,5,6,1,5,2,0,1,5,2,2,0,1,0,1,0,27,12,39,5,4,12.8205128205128,10.2564102564103,30.7692307692308,69.2307692307692
"79","21","1",10,6,5,6,7,11,7,4,7,5,13,5,5,6,4,5,59,50,109,15,24,13.7614678899083,22.0183486238532,45.8715596330275,54.1284403669725
"80","21","2",13,6,6,8,6,5,6,5,6,8,4,3,8,3,5,1,56,40,96,14,9,14.5833333333333,9.375,41.6666666666667,58.3333333333333
"81","21","3",8,4,5,2,4,3,2,3,3,3,2,3,2,2,2,2,31,22,53,10,5,18.8679245283019,9.43396226415094,41.5094339622642,58.4905660377358
"82","21","4",1,2,2,3,1,2,4,0,2,3,2,1,4,1,1,0,17,15,32,1,4,3.125,12.5,46.875,53.125
"83","21","5",1,2,2,1,1,2,2,0,1,1,1,1,2,0,0,0,13,7,20,1,3,5,15,35,65
"84","21","6",6,3,3,1,4,11,1,0,3,1,12,0,0,1,0,0,30,19,49,6,23,12.2448979591837,46.9387755102041,38.7755102040816,61.2244897959184
"85","22","1",0,0,1,2,1,14,4,10,1,3,14,12,3,11,10,20,35,74,109,20,28,18.348623853211,25.6880733944954,67.8899082568807,32.1100917431193
"86","22","2",1,2,6,4,4,9,7,6,2,8,7,10,6,7,6,7,40,55,95,8,16,8.42105263157895,16.8421052631579,57.8947368421053,42.1052631578947
"87","22","3",0,0,1,3,1,9,4,5,0,4,9,6,3,6,4,4,23,39,62,4,18,6.45161290322581,29.0322580645161,62.9032258064516,37.0967741935484
"88","22","4",0,0,2,1,1,15,2,1,0,3,13,2,2,1,1,5,23,29,52,5,28,9.61538461538461,53.8461538461538,55.7692307692308,44.2307692307692
"89","22","5",2,3,3,2,3,6,3,2,3,2,6,3,2,3,2,1,24,25,49,3,12,6.12244897959184,24.4897959183673,51.0204081632653,48.9795918367347
"90","22","6",0,1,1,1,0,4,3,1,1,1,3,3,2,2,0,0,11,15,26,0,7,0,26.9230769230769,57.6923076923077,42.3076923076923
"91","23","1",7,11,12,12,11,8,8,14,11,13,8,10,13,9,14,7,85,86,171,14,16,8.18713450292398,9.35672514619883,50.2923976608187,49.7076023391813
"92","23","2",24,16,16,7,18,6,7,2,16,7,7,2,6,3,2,1,98,45,143,25,13,17.4825174825175,9.09090909090909,31.4685314685315,68.5314685314685
"93","23","3",8,6,8,0,7,4,2,1,6,3,3,2,2,1,1,1,38,20,58,9,7,15.5172413793103,12.0689655172414,34.4827586206897,65.5172413793103
"94","23","4",26,4,3,1,3,1,2,0,4,0,1,1,1,1,0,0,43,8,51,26,2,50.9803921568627,3.92156862745098,15.6862745098039,84.3137254901961
"95","23","5",16,5,7,3,7,2,3,1,5,5,3,1,2,2,1,0,46,20,66,16,5,24.2424242424242,7.57575757575758,30.3030303030303,69.6969696969697
"96","23","6",18,5,5,1,4,2,2,0,5,1,1,1,2,0,0,0,39,11,50,18,3,36,6,22,78
"97","24","1",14,9,10,2,10,14,1,3,9,3,14,2,2,1,2,2,63,38,101,16,28,15.8415841584158,27.7227722772277,37.6237623762376,62.3762376237624
"98","24","2",2,3,4,6,5,2,4,6,3,6,3,4,4,5,5,10,32,43,75,12,5,16,6.66666666666667,57.3333333333333,42.6666666666667
"99","24","3",2,5,4,2,4,7,2,3,5,1,7,3,2,4,4,8,30,36,66,10,14,15.1515151515152,21.2121212121212,54.5454545454545,45.4545454545455
"100","24","4",3,1,5,2,4,4,7,1,1,6,3,6,3,5,1,1,30,26,56,4,7,7.14285714285714,12.5,46.4285714285714,53.5714285714286
"101","24","5",1,2,4,2,3,2,1,1,2,4,2,0,3,0,2,7,18,21,39,8,4,20.5128205128205,10.2564102564103,53.8461538461538,46.1538461538462
"102","24","6",1,2,3,4,5,4,3,4,3,5,6,3,3,4,4,2,29,30,59,3,10,5.08474576271186,16.9491525423729,50.8474576271186,49.1525423728814
"103","25","1",19,6,6,6,5,6,6,5,7,6,5,5,7,4,5,5,62,44,106,24,11,22.6415094339623,10.377358490566,41.5094339622642,58.4905660377358
"104","25","2",2,3,2,4,2,1,2,7,3,3,1,5,4,5,8,8,24,39,63,10,2,15.8730158730159,3.17460317460317,61.9047619047619,38.0952380952381
"105","25","3",9,2,1,4,2,3,3,2,2,3,3,2,3,2,2,1,27,20,47,10,6,21.2765957446809,12.7659574468085,42.5531914893617,57.4468085106383
"106","25","4",3,2,1,4,1,1,1,4,2,2,1,1,3,1,3,8,17,24,41,11,2,26.8292682926829,4.8780487804878,58.5365853658537,41.4634146341463
"107","25","5",2,3,2,3,0,3,4,3,3,2,1,3,5,2,3,17,21,38,59,19,4,32.2033898305085,6.77966101694915,64.406779661017,35.5932203389831
"108","25","6",6,5,5,4,6,1,3,3,5,4,2,1,4,2,3,3,35,25,60,9,3,15,5,41.6666666666667,58.3333333333333
"109","26","1",5,11,23,5,25,344,24,14,11,17,346,33,3,35,14,1,453,461,914,6,690,0.656455142231947,75.492341356674,50.437636761488,49.562363238512
"110","26","2",0,1,21,2,21,400,22,1,1,22,400,21,2,21,1,0,469,470,939,0,800,0,85.1970181043664,50.0532481363152,49.9467518636848
"111","26","3",0,1,8,0,8,385,9,3,1,7,384,12,0,12,3,0,415,421,836,0,769,0,91.9856459330144,50.3588516746412,49.6411483253588
"112","26","4",0,1,5,1,6,341,9,4,1,5,342,12,0,13,4,0,369,378,747,0,683,0,91.4323962516734,50.6024096385542,49.3975903614458
"113","26","5",0,0,18,0,17,543,18,0,0,18,543,18,1,17,0,0,598,598,1196,0,1086,0,90.8026755852843,50,50
"114","26","6",0,3,13,0,12,387,9,1,3,10,385,10,1,9,1,0,426,421,847,0,772,0,91.1452184179457,49.7048406139315,50.2951593860685
"115","27","1",24,16,16,7,15,12,7,5,16,8,10,5,9,3,5,2,104,59,163,26,22,15.9509202453988,13.4969325153374,36.1963190184049,63.8036809815951
"116","27","2",9,10,10,3,10,55,9,1,10,3,55,7,3,7,1,0,108,88,196,9,110,4.59183673469388,56.1224489795918,44.8979591836735,55.1020408163265
"117","27","3",20,18,18,5,17,28,7,3,17,6,27,5,6,4,3,0,118,69,187,20,55,10.6951871657754,29.4117647058824,36.8983957219251,63.1016042780749
"118","27","4",5,8,10,6,12,50,10,5,8,8,53,9,3,12,5,0,108,99,207,5,103,2.41545893719807,49.7584541062802,47.8260869565217,52.1739130434783
"119","27","5",2,4,8,9,13,86,22,2,3,13,92,15,3,21,2,1,148,151,299,3,178,1.00334448160535,59.5317725752508,50.5016722408027,49.4983277591973
"120","27","6",0,1,4,8,8,106,18,1,1,11,110,11,4,15,1,0,147,155,302,0,216,0,71.523178807947,51.3245033112583,48.6754966887417
"121","28","1",20,10,9,6,11,9,5,4,10,6,10,3,5,4,4,2,76,45,121,22,19,18.1818181818182,15.702479338843,37.1900826446281,62.8099173553719
"122","28","2",17,8,16,2,14,11,3,1,7,10,10,2,3,1,1,1,74,36,110,18,21,16.3636363636364,19.0909090909091,32.7272727272727,67.2727272727273
"123","28","3",0,0,1,2,0,12,0,8,0,3,11,6,3,4,7,61,23,98,121,61,23,50.4132231404959,19.0082644628099,80.9917355371901,19.0082644628099
"124","28","4",0,0,0,0,0,0,0,6,0,0,0,6,0,6,6,89,6,110,116,89,0,76.7241379310345,0,94.8275862068966,5.17241379310345
"125","28","5",0,0,0,0,0,1,0,1,0,0,1,1,0,1,1,84,2,91,93,84,2,90.3225806451613,2.1505376344086,97.8494623655914,2.1505376344086
"126","28","6",0,0,0,0,0,0,0,2,0,0,0,2,0,2,2,85,2,94,96,85,0,88.5416666666667,0,97.9166666666667,2.08333333333333
"127","29","1",3,9,8,6,9,44,6,13,9,4,45,13,4,14,12,16,98,120,218,19,89,8.71559633027523,40.8256880733945,55.045871559633,44.954128440367
"128","29","2",8,5,15,3,14,45,3,11,5,13,44,10,4,10,11,12,105,111,216,20,89,9.25925925925926,41.2037037037037,51.3888888888889,48.6111111111111
"129","29","3",0,2,9,4,11,50,3,8,2,11,53,6,2,9,8,3,89,95,184,3,103,1.6304347826087,55.9782608695652,51.6304347826087,48.3695652173913
"130","29","4",5,5,10,2,12,49,4,2,5,7,51,4,1,5,2,1,91,77,168,6,100,3.57142857142857,59.5238095238095,45.8333333333333,54.1666666666667
"131","29","5",0,0,4,6,7,89,8,1,0,10,92,3,3,6,1,0,117,116,233,0,181,0,77.6824034334764,49.7854077253219,50.2145922746781
"132","29","6",0,0,0,6,6,68,5,1,0,6,75,0,0,6,1,2,88,91,179,2,143,1.11731843575419,79.8882681564246,50.8379888268156,49.1620111731844
"133","3","1",27,14,13,2,12,4,1,1,13,1,3,0,2,0,1,0,75,22,97,27,7,27.8350515463918,7.21649484536082,22.680412371134,77.319587628866
"134","3","2",15,8,14,3,13,11,5,3,8,9,10,4,4,4,3,0,73,44,117,15,21,12.8205128205128,17.9487179487179,37.6068376068376,62.3931623931624
"135","3","3",67,7,6,2,6,0,1,1,7,1,0,0,2,0,1,1,93,12,105,68,0,64.7619047619048,0,11.4285714285714,88.5714285714286
"136","3","4",56,2,1,1,1,1,0,0,1,0,1,0,0,0,0,0,63,4,67,56,2,83.5820895522388,2.98507462686567,5.97014925373134,94.0298507462687
"137","3","5",76,1,1,0,1,0,0,0,1,0,0,0,0,0,0,0,82,1,83,76,0,91.566265060241,0,1.20481927710843,98.7951807228916
"138","3","6",41,3,3,1,3,0,0,1,3,1,0,0,1,0,1,0,55,6,61,41,0,67.2131147540984,0,9.83606557377049,90.1639344262295
"139","30","1",12,7,5,6,6,2,2,5,7,4,3,1,5,2,5,4,48,31,79,16,5,20.253164556962,6.32911392405063,39.2405063291139,60.7594936708861
"140","30","2",13,9,8,5,10,2,5,0,9,5,4,0,3,2,0,0,54,24,78,13,6,16.6666666666667,7.69230769230769,30.7692307692308,69.2307692307692
"141","30","3",17,7,4,3,5,3,4,1,6,0,4,2,1,3,0,2,44,21,65,19,7,29.2307692307692,10.7692307692308,32.3076923076923,67.6923076923077
"142","30","4",0,0,1,0,0,3,0,4,0,1,2,4,1,3,4,5,9,22,31,5,5,16.1290322580645,16.1290322580645,70.9677419354839,29.0322580645161
"143","30","5",11,2,4,0,5,1,0,0,2,2,1,0,0,0,0,0,25,6,31,11,2,35.4838709677419,6.45161290322581,19.3548387096774,80.6451612903226
"144","30","6",7,2,4,0,3,1,1,0,2,2,0,1,1,0,0,0,20,7,27,7,1,25.9259259259259,3.7037037037037,25.9259259259259,74.0740740740741
"145","31","1",8,7,8,6,9,17,7,6,7,7,18,7,5,8,6,7,68,68,136,15,35,11.0294117647059,25.7352941176471,50,50
"146","31","2",3,1,3,9,3,4,7,9,2,11,4,7,10,7,10,14,42,65,107,17,8,15.8878504672897,7.47663551401869,60.7476635514019,39.2523364485981
"147","31","3",0,0,2,3,1,2,5,6,0,5,1,8,3,7,5,11,19,43,62,11,3,17.741935483871,4.83870967741935,69.3548387096774,30.6451612903226
"148","31","4",0,0,2,2,0,2,4,5,0,4,0,7,4,6,6,9,16,38,54,9,2,16.6666666666667,3.7037037037037,70.3703703703704,29.6296296296296
"149","31","5",2,0,1,3,1,6,5,2,1,3,6,4,3,4,2,1,23,24,47,3,12,6.38297872340426,25.531914893617,51.063829787234,48.936170212766
"150","31","6",1,3,6,5,4,5,8,6,3,7,3,9,7,7,6,6,40,49,89,7,8,7.86516853932584,8.98876404494382,55.0561797752809,44.9438202247191
"151","32","1",0,3,6,5,7,14,9,3,3,8,14,7,4,8,3,14,48,63,111,14,28,12.6126126126126,25.2252252252252,56.7567567567568,43.2432432432432
"152","32","2",33,8,7,7,9,4,6,6,8,6,6,5,5,7,6,6,83,49,132,39,10,29.5454545454545,7.57575757575758,37.1212121212121,62.8787878787879
"153","32","3",73,5,5,0,5,2,0,0,5,0,2,0,0,0,0,0,93,7,100,73,4,73,4,7,93
"154","32","4",43,10,9,2,10,0,2,0,10,2,1,0,2,0,0,0,78,16,94,43,1,45.7446808510638,1.06382978723404,17.0212765957447,82.9787234042553
"155","32","5",53,7,6,1,7,0,1,0,7,0,1,0,0,1,0,0,77,10,87,53,1,60.9195402298851,1.14942528735632,11.4942528735632,88.5057471264368
"156","32","6",27,6,7,0,6,6,1,0,5,2,5,1,1,0,0,0,55,15,70,27,11,38.5714285714286,15.7142857142857,21.4285714285714,78.5714285714286
"157","33","1",3,3,3,1,3,4,2,3,3,1,4,3,1,3,2,0,22,20,42,3,8,7.14285714285714,19.047619047619,47.6190476190476,52.3809523809524
"158","33","2",0,0,0,1,0,0,1,4,0,1,0,4,2,3,4,11,8,26,34,11,0,32.3529411764706,0,76.4705882352941,23.5294117647059
"159","33","3",0,0,0,1,0,0,0,1,0,1,0,0,0,0,0,1,2,5,7,1,0,14.2857142857143,0,71.4285714285714,28.5714285714286
"160","33","4",0,0,0,0,0,0,0,0,0,0,0,0,0,0,0,0,0,0,0,0,0,NA,NA,NA,NA
"161","33","5",0,0,0,0,0,0,0,0,0,0,0,0,0,0,0,0,0,0,0,0,0,NA,NA,NA,NA
"162","33","6",0,0,0,0,0,0,0,0,0,0,0,0,0,0,0,0,0,0,0,0,0,NA,NA,NA,NA
"163","34","1",9,5,6,12,12,7,11,8,5,13,13,7,6,13,8,5,70,73,143,14,20,9.79020979020979,13.986013986014,51.048951048951,48.951048951049
"164","34","2",5,4,4,2,5,16,5,2,4,2,17,5,1,7,3,6,44,47,91,11,33,12.0879120879121,36.2637362637363,51.6483516483516,48.3516483516484
"165","34","3",7,6,7,3,5,5,4,3,6,3,4,4,4,3,3,4,42,32,74,11,9,14.8648648648649,12.1621621621622,43.2432432432432,56.7567567567568
"166","34","4",2,2,3,2,5,1,0,2,3,3,2,0,1,1,2,7,20,19,39,9,3,23.0769230769231,7.69230769230769,48.7179487179487,51.2820512820513
"167","34","5",2,4,5,2,5,7,3,1,4,3,7,2,2,2,1,0,30,23,53,2,14,3.77358490566038,26.4150943396226,43.3962264150943,56.6037735849057
"168","34","6",1,1,0,2,1,0,2,0,1,1,1,1,1,2,0,0,8,9,17,1,1,5.88235294117647,5.88235294117647,52.9411764705882,47.0588235294118
"169","35","1",0,3,5,5,4,7,8,6,3,7,6,8,6,8,6,5,39,51,90,5,13,5.55555555555556,14.4444444444444,56.6666666666667,43.3333333333333
"170","35","2",4,2,2,0,2,0,0,0,2,0,0,0,0,0,0,0,12,3,15,4,0,26.6666666666667,0,20,80
"171","35","3",15,5,5,1,5,0,1,0,6,1,0,0,1,0,0,0,35,8,43,15,0,34.8837209302326,0,18.6046511627907,81.3953488372093
"172","35","4",0,0,0,0,0,0,0,0,0,0,0,0,0,0,0,0,0,0,0,0,0,NA,NA,NA,NA
"173","35","5",12,2,1,1,1,1,0,0,1,0,1,0,0,0,0,0,19,4,23,12,2,52.1739130434783,8.69565217391304,17.3913043478261,82.6086956521739
"174","35","6",2,1,1,0,1,0,0,0,1,0,0,0,0,0,0,0,8,1,9,2,0,22.2222222222222,0,11.1111111111111,88.8888888888889
"175","36","1",2,5,4,5,7,2,3,4,6,4,5,2,3,5,5,4,35,34,69,6,7,8.69565217391304,10.1449275362319,49.2753623188406,50.7246376811594
"176","36","2",0,0,1,1,0,3,1,6,0,2,2,6,2,5,5,26,12,51,63,26,5,41.2698412698413,7.93650793650794,80.9523809523809,19.047619047619
"177","36","3",9,2,3,2,2,10,4,6,2,3,9,8,4,6,6,10,40,49,89,19,19,21.3483146067416,21.3483146067416,55.0561797752809,44.9438202247191
"178","36","4",16,7,7,4,6,5,3,3,7,3,4,3,4,2,3,3,52,31,83,19,9,22.8915662650602,10.8433734939759,37.3493975903614,62.6506024096386
"179","36","5",1,2,4,3,3,8,4,5,2,4,7,6,3,6,5,10,31,45,76,11,15,14.4736842105263,19.7368421052632,59.2105263157895,40.7894736842105
"180","36","6",2,1,2,3,2,3,1,6,1,4,2,4,3,3,5,11,20,36,56,13,5,23.2142857142857,8.92857142857143,64.2857142857143,35.7142857142857
"181","37","1",7,4,4,4,5,10,5,4,4,4,10,5,3,6,4,7,44,45,89,14,20,15.7303370786517,22.4719101123596,50.561797752809,49.438202247191
"182","37","2",4,6,4,10,7,8,7,10,6,8,11,7,8,10,10,7,58,68,126,11,19,8.73015873015873,15.0793650793651,53.968253968254,46.031746031746
"183","37","3",17,9,9,4,7,6,7,7,10,4,4,10,7,8,8,8,69,59,128,25,10,19.53125,7.8125,46.09375,53.90625
"184","37","4",9,9,9,6,8,7,5,6,9,5,6,6,6,5,6,6,60,51,111,15,13,13.5135135135135,11.7117117117117,45.9459459459459,54.0540540540541
"185","37","5",6,5,4,10,6,5,7,7,5,9,6,4,9,5,7,10,52,56,108,16,11,14.8148148148148,10.1851851851852,51.8518518518519,48.1481481481481
"186","37","6",0,0,2,7,2,3,8,8,0,8,3,9,6,9,8,6,31,51,82,6,6,7.31707317073171,7.31707317073171,62.1951219512195,37.8048780487805
"187","38","1",28,12,13,7,15,9,8,4,12,8,11,5,5,7,4,0,98,53,151,28,20,18.5430463576159,13.2450331125828,35.0993377483444,64.9006622516556
"188","38","2",8,7,3,8,3,6,9,4,6,4,6,5,8,5,4,5,50,44,94,13,12,13.8297872340426,12.7659574468085,46.8085106382979,53.1914893617021
"189","38","3",14,7,5,8,8,4,3,6,7,6,7,1,5,4,6,11,58,47,105,25,11,23.8095238095238,10.4761904761905,44.7619047619048,55.2380952380952
"190","38","4",7,3,6,2,6,7,5,5,3,5,6,8,2,8,5,3,42,42,84,10,13,11.9047619047619,15.4761904761905,50,50
"191","38","5",0,4,3,4,3,4,8,3,4,4,4,6,5,6,3,1,31,34,65,1,8,1.53846153846154,12.3076923076923,52.3076923076923,47.6923076923077
"192","38","6",2,2,5,4,4,6,6,0,2,7,5,2,5,1,0,0,31,23,54,2,11,3.7037037037037,20.3703703703704,42.5925925925926,57.4074074074074
"193","39","1",20,13,12,7,11,11,9,3,13,6,10,5,8,4,3,1,89,50,139,21,21,15.1079136690647,15.1079136690647,35.9712230215827,64.0287769784173
"194","39","2",12,10,9,5,10,11,5,3,9,4,12,4,3,5,3,2,66,44,110,14,23,12.7272727272727,20.9090909090909,40,60
"195","39","3",0,4,5,4,6,3,4,5,4,5,5,5,3,7,6,10,33,46,79,10,8,12.6582278481013,10.126582278481,58.2278481012658,41.7721518987342
"196","39","4",21,5,4,2,4,6,2,4,6,1,6,3,3,3,4,2,51,28,79,23,12,29.1139240506329,15.1898734177215,35.4430379746835,64.5569620253165
"197","39","5",5,3,1,7,2,2,7,4,2,5,3,4,5,5,3,3,31,33,64,8,5,12.5,7.8125,51.5625,48.4375
"198","39","6",7,5,1,4,0,1,4,4,5,0,1,3,5,3,4,3,28,25,53,10,2,18.8679245283019,3.77358490566038,47.1698113207547,52.8301886792453
"199","4","1",13,6,9,7,7,12,9,6,6,10,11,8,8,7,6,7,71,64,135,20,23,14.8148148148148,17.037037037037,47.4074074074074,52.5925925925926
"200","4","2",8,7,4,6,7,9,5,5,7,3,12,4,3,6,5,3,52,45,97,11,21,11.340206185567,21.6494845360825,46.3917525773196,53.6082474226804
"201","4","3",1,4,6,5,5,6,3,5,4,7,6,3,6,3,5,6,37,41,78,7,12,8.97435897435897,15.3846153846154,52.5641025641026,47.4358974358974
"202","4","4",0,0,0,1,0,1,3,6,0,1,1,9,1,8,6,10,12,38,50,10,2,20,4,76,24
"203","4","5",0,0,0,0,0,1,2,3,0,0,1,5,1,5,3,5,8,21,29,5,2,17.2413793103448,6.89655172413793,72.4137931034483,27.5862068965517
"204","4","6",0,1,0,3,1,1,1,3,1,1,2,1,1,2,3,2,11,15,26,2,3,7.69230769230769,11.5384615384615,57.6923076923077,42.3076923076923
"205","40","1",1,1,2,2,2,12,6,13,1,3,12,17,2,18,14,16,40,85,125,17,24,13.6,19.2,68,32
"206","40","2",1,3,2,4,4,4,3,12,3,3,6,11,2,13,12,15,34,67,101,16,10,15.8415841584158,9.9009900990099,66.3366336633663,33.6633663366337
"207","40","3",0,0,0,2,0,6,4,8,0,2,7,9,2,10,8,35,22,74,96,35,13,36.4583333333333,13.5416666666667,77.0833333333333,22.9166666666667
"208","40","4",0,2,2,4,3,6,4,6,3,4,6,6,4,6,6,11,30,46,76,11,12,14.4736842105263,15.7894736842105,60.5263157894737,39.4736842105263
"209","40","5",0,1,1,4,1,4,3,6,1,4,4,6,4,6,6,12,21,45,66,12,8,18.1818181818182,12.1212121212121,68.1818181818182,31.8181818181818
"210","40","6",2,1,0,2,0,0,0,3,0,1,1,1,1,2,3,1,10,11,21,3,1,14.2857142857143,4.76190476190476,52.3809523809524,47.6190476190476
"211","41","1",18,15,16,12,16,28,16,7,15,13,28,11,12,11,6,12,128,111,239,30,56,12.5523012552301,23.4309623430962,46.4435146443515,53.5564853556485
"212","41","2",18,14,12,18,15,11,18,13,14,16,14,13,15,17,14,9,120,114,234,27,25,11.5384615384615,10.6837606837607,48.7179487179487,51.2820512820513
"213","41","3",24,14,13,3,13,15,6,7,14,2,15,10,2,11,7,8,96,71,167,32,30,19.1616766467066,17.9640718562874,42.5149700598802,57.4850299401198
"214","41","4",29,12,12,8,10,18,13,5,12,9,16,10,10,8,5,5,109,76,185,34,34,18.3783783783784,18.3783783783784,41.0810810810811,58.9189189189189
"215","41","5",16,7,12,5,8,12,6,5,6,10,8,6,8,2,4,8,71,55,126,24,20,19.047619047619,15.8730158730159,43.6507936507937,56.3492063492063
"216","41","6",10,4,3,9,7,5,6,5,4,8,9,2,5,5,5,8,50,48,98,18,14,18.3673469387755,14.2857142857143,48.9795918367347,51.0204081632653
"217","42","1",12,15,19,9,17,34,18,5,15,13,32,14,11,12,5,4,131,107,238,16,66,6.72268907563025,27.7310924369748,44.9579831932773,55.0420168067227
"218","42","2",19,15,16,7,17,42,10,5,15,8,43,8,6,10,6,2,132,100,232,21,85,9.05172413793103,36.6379310344828,43.1034482758621,56.8965517241379
"219","42","3",15,12,16,4,13,34,9,7,12,7,31,12,6,9,6,0,110,86,196,15,65,7.6530612244898,33.1632653061224,43.8775510204082,56.1224489795918
"220","42","4",14,10,15,3,12,30,10,6,10,8,28,13,6,10,6,5,102,87,189,19,58,10.0529100529101,30.6878306878307,46.031746031746,53.968253968254
"221","42","5",7,11,18,7,16,32,12,5,11,14,31,10,9,8,5,0,110,89,199,7,63,3.51758793969849,31.6582914572864,44.7236180904523,55.2763819095477
"222","42","6",5,4,5,11,6,35,14,16,3,12,36,19,9,21,16,16,97,134,231,21,71,9.09090909090909,30.7359307359307,58.008658008658,41.991341991342
"223","43","1",44,16,18,9,20,19,9,10,15,11,21,10,7,12,10,6,147,93,240,50,40,20.8333333333333,16.6666666666667,38.75,61.25
"224","43","2",60,9,11,8,12,5,7,9,8,10,6,8,6,9,8,11,121,69,190,71,11,37.3684210526316,5.78947368421053,36.3157894736842,63.6842105263158
"225","43","3",85,9,7,6,10,3,4,2,8,5,6,0,3,3,2,1,128,29,157,86,9,54.7770700636943,5.73248407643312,18.4713375796178,81.5286624203822
"226","43","4",79,4,7,3,6,17,7,4,4,6,16,8,4,7,4,5,130,54,184,84,33,45.6521739130435,17.9347826086957,29.3478260869565,70.6521739130435
"227","43","5",55,2,1,7,5,16,8,4,2,6,20,5,3,9,4,1,101,50,151,56,36,37.0860927152318,23.841059602649,33.112582781457,66.887417218543
"228","43","6",60,4,3,2,4,3,1,1,3,1,4,0,0,2,1,0,79,13,92,60,7,65.2173913043478,7.60869565217391,14.1304347826087,85.8695652173913
"229","44","1",15,5,15,4,9,20,8,11,5,13,14,15,10,9,11,44,89,122,211,59,34,27.9620853080569,16.1137440758294,57.8199052132701,42.1800947867299
"230","44","2",6,7,13,9,6,32,17,12,7,15,25,20,16,12,11,10,102,119,221,16,57,7.23981900452489,25.7918552036199,53.8461538461538,46.1538461538462
"231","44","3",5,4,8,6,9,21,12,12,4,10,22,18,5,18,11,27,77,118,195,32,43,16.4102564102564,22.0512820512821,60.5128205128205,39.4871794871795
"232","44","4",7,7,12,6,12,12,7,8,7,12,12,9,7,9,9,13,73,79,152,20,24,13.1578947368421,15.7894736842105,51.9736842105263,48.0263157894737
"233","44","5",1,4,7,5,7,17,10,4,4,8,17,10,5,10,4,6,56,66,122,7,34,5.73770491803279,27.8688524590164,54.0983606557377,45.9016393442623
"234","44","6",6,7,5,9,8,21,9,8,7,7,24,8,6,12,8,5,74,79,153,11,45,7.18954248366013,29.4117647058824,51.6339869281046,48.3660130718954
"235","45","1",0,1,2,6,3,4,5,13,0,7,5,12,4,13,12,47,34,103,137,47,9,34.3065693430657,6.56934306569343,75.1824817518248,24.8175182481752
"236","45","2",1,2,0,3,3,6,3,6,1,2,9,6,0,9,6,53,26,87,113,54,15,47.787610619469,13.2743362831858,76.9911504424779,23.0088495575221
"237","45","3",3,4,4,2,4,201,6,10,4,2,201,14,2,13,9,40,234,288,522,43,402,8.23754789272031,77.0114942528736,55.1724137931034,44.8275862068966
"238","45","4",3,4,5,4,4,43,7,10,4,5,42,12,5,11,9,14,80,105,185,17,85,9.18918918918919,45.9459459459459,56.7567567567568,43.2432432432432
"239","45","5",0,2,4,5,2,16,7,9,2,7,14,10,7,8,8,20,45,79,124,20,30,16.1290322580645,24.1935483870968,63.7096774193548,36.2903225806452
"240","45","6",0,0,3,2,3,5,2,10,0,5,5,9,2,9,9,45,25,87,112,45,10,40.1785714285714,8.92857142857143,77.6785714285714,22.3214285714286
"241","46","1",4,4,7,4,6,6,4,4,4,6,5,4,4,3,3,6,39,38,77,10,11,12.987012987013,14.2857142857143,49.3506493506493,50.6493506493507
"242","46","2",3,1,2,7,0,7,3,13,1,8,5,10,9,7,13,19,37,74,111,22,12,19.8198198198198,10.8108108108108,66.6666666666667,33.3333333333333
"243","46","3",1,2,3,3,2,528,1,12,2,4,526,10,4,9,12,39,553,608,1161,40,1054,3.44530577088717,90.7838070628768,52.3686477174849,47.6313522825151
"244","46","4",2,2,3,1,2,1374,5,9,2,2,1373,13,2,12,9,26,1400,1440,2840,28,2747,0.985915492957746,96.7253521126761,50.7042253521127,49.2957746478873
"245","46","5",1,2,2,3,1,956,3,7,2,3,954,7,5,5,7,13,977,997,1974,14,1910,0.709219858156028,96.757852077001,50.5065856129686,49.4934143870314
"246","46","6",1,2,1,4,1,189,6,8,2,3,189,11,4,10,8,6,213,235,448,7,378,1.5625,84.375,52.4553571428571,47.5446428571429
"247","47","1",2,3,3,6,8,25,5,4,3,6,30,3,1,9,5,4,57,63,120,6,55,5,45.8333333333333,52.5,47.5
"248","47","2",1,3,5,0,3,5,0,1,3,2,4,1,1,0,1,0,20,13,33,1,9,3.03030303030303,27.2727272727273,39.3939393939394,60.6060606060606
"249","47","3",0,0,0,0,1,4,0,1,0,0,5,1,0,1,1,0,8,9,17,0,9,0,52.9411764705882,52.9411764705882,47.0588235294118
"250","47","4",0,2,2,2,4,416,1,1,2,3,418,0,1,1,1,0,430,427,857,0,834,0,97.316219369895,49.8249708284714,50.1750291715286
"251","47","5",5,3,1,2,2,237,1,2,3,0,238,1,1,2,2,0,254,249,503,5,475,0.99403578528827,94.4333996023857,49.5029821073559,50.4970178926441
"252","47","6",2,1,2,0,3,2,0,0,1,1,2,0,0,0,0,0,12,5,17,2,4,11.7647058823529,23.5294117647059,29.4117647058824,70.5882352941177
"253","48","1",3,6,7,4,5,10,6,6,6,5,8,8,7,6,7,3,49,51,100,6,18,6,18,51,49
"254","48","2",0,1,0,4,1,3,5,7,1,3,5,8,3,10,8,12,23,51,74,12,8,16.2162162162162,10.8108108108108,68.9189189189189,31.0810810810811
"255","48","3",4,6,8,2,5,6,6,0,6,4,4,4,5,1,0,0,39,25,64,4,10,6.25,15.625,39.0625,60.9375
"256","48","4",5,3,7,2,7,6,3,2,3,6,6,3,2,3,2,0,36,27,63,5,12,7.93650793650794,19.047619047619,42.8571428571429,57.1428571428571
"257","48","5",8,6,8,1,6,5,4,0,5,3,3,3,2,1,0,0,39,19,58,8,8,13.7931034482759,13.7931034482759,32.7586206896552,67.2413793103448
"258","48","6",5,3,3,3,4,2,1,3,3,3,3,2,1,3,3,1,25,21,46,6,5,13.0434782608696,10.8695652173913,45.6521739130435,54.3478260869565
"259","5","1",5,6,9,6,8,16,10,5,5,9,15,9,6,9,5,7,66,67,133,12,31,9.02255639097744,23.3082706766917,50.3759398496241,49.6240601503759
"260","5","2",3,5,6,3,4,35,4,4,5,5,33,5,5,3,4,0,66,61,127,3,68,2.36220472440945,53.5433070866142,48.0314960629921,51.9685039370079
"261","5","3",2,4,8,4,3,16,10,10,4,8,11,15,9,10,10,19,58,88,146,21,27,14.3835616438356,18.4931506849315,60.2739726027397,39.7260273972603
"262","5","4",10,5,9,3,7,22,7,2,4,7,20,6,4,5,2,2,66,52,118,12,42,10.1694915254237,35.5932203389831,44.0677966101695,55.9322033898305
"263","5","5",4,4,9,1,8,16,6,0,5,6,15,5,2,4,0,0,51,37,88,4,31,4.54545454545455,35.2272727272727,42.0454545454545,57.9545454545455
"264","5","6",21,6,3,6,4,14,7,6,6,3,15,7,4,8,6,7,68,58,126,28,29,22.2222222222222,23.015873015873,46.031746031746,53.968253968254
"265","6","1",8,5,8,8,7,13,6,6,5,11,12,5,8,4,6,3,62,56,118,11,25,9.32203389830508,21.1864406779661,47.4576271186441,52.5423728813559
"266","6","2",8,7,7,5,9,16,8,4,6,5,19,7,2,10,4,8,66,62,128,16,35,12.5,27.34375,48.4375,51.5625
"267","6","3",0,1,3,4,5,31,6,5,2,6,33,7,3,8,5,4,58,68,126,4,64,3.17460317460317,50.7936507936508,53.968253968254,46.031746031746
"268","6","4",17,5,8,1,9,10,1,1,5,4,10,1,0,1,1,1,53,25,78,18,20,23.0769230769231,25.6410256410256,32.0512820512821,67.9487179487179
"269","6","5",8,5,6,5,10,7,6,0,5,6,11,1,1,5,0,0,48,31,79,8,18,10.126582278481,22.7848101265823,39.2405063291139,60.7594936708861
"270","6","6",7,3,3,0,1,1,1,2,3,0,0,3,2,2,3,7,20,21,41,14,1,34.1463414634146,2.4390243902439,51.219512195122,48.780487804878
"271","7","1",20,10,13,4,14,9,5,0,10,8,9,1,4,1,0,0,77,34,111,20,18,18.018018018018,16.2162162162162,30.6306306306306,69.3693693693694
"272","7","2",31,8,9,2,8,8,3,0,8,3,6,1,3,0,0,0,70,23,93,31,14,33.3333333333333,15.0537634408602,24.7311827956989,75.2688172043011
"273","7","3",23,5,3,5,3,6,7,7,4,3,7,9,4,10,7,10,61,55,116,33,13,28.448275862069,11.2068965517241,47.4137931034483,52.5862068965517
"274","7","4",14,4,2,3,0,3,4,3,4,1,1,4,5,3,4,4,34,28,62,18,4,29.0322580645161,6.45161290322581,45.1612903225806,54.8387096774194
"275","7","5",1,5,4,7,6,7,3,10,5,5,9,6,5,8,10,25,45,74,119,26,16,21.8487394957983,13.4453781512605,62.1848739495798,37.8151260504202
"276","7","6",0,0,2,5,3,8,4,7,0,7,9,6,3,8,7,4,30,46,76,4,17,5.26315789473684,22.3684210526316,60.5263157894737,39.4736842105263
"277","8","1",4,5,4,7,5,17,10,4,6,6,18,7,7,7,4,2,59,57,116,6,35,5.17241379310345,30.1724137931034,49.1379310344828,50.8620689655172
"278","8","2",8,5,7,7,8,9,8,7,5,9,10,8,6,8,7,11,60,66,126,19,19,15.0793650793651,15.0793650793651,52.3809523809524,47.6190476190476
"279","8","3",4,7,5,4,7,8,3,5,7,2,10,3,2,6,5,0,44,37,81,4,18,4.93827160493827,22.2222222222222,45.679012345679,54.320987654321
"280","8","4",1,3,3,4,2,7,4,6,3,4,6,6,5,5,5,11,30,48,78,12,13,15.3846153846154,16.6666666666667,61.5384615384615,38.4615384615385
"281","8","5",0,0,1,2,0,1,4,10,0,3,0,12,3,12,11,22,19,65,84,22,1,26.1904761904762,1.19047619047619,77.3809523809524,22.6190476190476
"282","8","6",0,2,0,2,2,2,4,5,2,1,4,6,1,8,5,10,19,38,57,10,6,17.5438596491228,10.5263157894737,66.6666666666667,33.3333333333333
"283","9","1",4,3,5,4,5,15,3,7,3,7,15,6,5,5,7,9,48,58,106,13,30,12.2641509433962,28.3018867924528,54.7169811320755,45.2830188679245
"284","9","2",14,4,5,8,3,7,12,5,4,9,5,9,10,6,4,8,58,58,116,22,12,18.9655172413793,10.3448275862069,50,50
"285","9","3",8,4,3,3,5,2,3,2,4,2,4,2,1,4,3,6,31,28,59,14,6,23.728813559322,10.1694915254237,47.4576271186441,52.5423728813559
"286","9","4",4,4,6,0,2,5,1,3,3,2,1,5,3,1,3,5,26,25,51,9,6,17.6470588235294,11.7647058823529,49.0196078431373,50.9803921568627
"287","9","5",0,2,5,3,3,9,4,4,2,5,7,6,4,4,4,1,31,35,66,1,16,1.51515151515152,24.2424242424242,53.030303030303,46.969696969697
"288","9","6",3,2,1,1,2,4,1,1,2,0,5,1,0,2,1,1,16,14,30,4,9,13.3333333333333,30,46.6666666666667,53.3333333333333
