"","fish_id","bin","LLLL","LLLR","LLRL","LLRR","LRLL","LRLR","LRRL","LRRR","RLLL","RLLR","RLRL","RLRR","RRLL","RRLR","RRRL","RRRR","L","R","total_turns","reps","alts","rel_reps","rel_alts","rel_R","rel_L"
"1","1","1",0,0,0,0,0,3170,0,0,0,0,3170,0,0,0,0,0,3171,3172,6343,0,6340,0,99.9527037679332,50.0078827053445,49.9921172946555
"2","1","2",0,0,0,0,0,2383,0,0,0,0,2382,0,0,0,0,0,2384,2384,4768,0,4765,0,99.9370805369127,50,50
"3","1","3",0,0,0,0,0,425,0,0,0,0,425,0,0,0,0,0,427,426,853,0,850,0,99.6483001172333,49.9413833528722,50.0586166471278
"4","1","4",0,0,0,0,0,98,0,0,0,0,99,0,0,0,0,0,100,100,200,0,197,0,98.5,50,50
"5","1","5",0,0,0,0,0,52,0,0,0,0,53,0,0,0,0,0,54,54,108,0,105,0,97.2222222222222,50,50
"6","1","6",0,0,0,0,0,17,0,0,0,0,17,0,0,0,0,0,18,19,37,0,34,0,91.8918918918919,51.3513513513514,48.6486486486486
"7","10","1",3,3,3,5,5,27,14,2,3,6,28,11,4,12,2,2,64,69,133,5,55,3.7593984962406,41.3533834586466,51.8796992481203,48.1203007518797
"8","10","2",2,2,7,1,5,16,6,3,2,7,14,8,4,5,3,8,44,52,96,10,30,10.4166666666667,31.25,54.1666666666667,45.8333333333333
"9","10","3",2,1,5,1,3,22,5,0,1,6,20,4,4,2,1,2,41,41,82,4,42,4.8780487804878,51.219512195122,50,50
"10","10","4",0,0,2,0,1,33,3,0,0,2,31,3,2,1,0,0,41,40,81,0,64,0,79.0123456790123,49.3827160493827,50.6172839506173
"11","10","5",0,0,3,1,2,45,3,0,0,4,45,2,2,2,0,0,56,56,112,0,90,0,80.3571428571429,50,50
"12","10","6",0,1,7,0,5,43,3,0,1,6,40,3,2,1,0,0,60,55,115,0,83,0,72.1739130434783,47.8260869565217,52.1739130434783
"13","10001","1",0,0,0,0,0,1,0,0,0,0,2,0,0,0,0,0,3,3,6,0,3,0,50,50,50
"14","10001","2",0,0,0,0,0,0,0,0,0,0,0,0,0,0,0,0,0,0,0,0,0,NA,NA,NA,NA
"15","10001","3",0,0,0,0,0,24,0,0,0,0,23,0,0,0,0,0,25,25,50,0,47,0,94,50,50
"16","10001","4",0,0,0,0,0,0,0,0,0,0,1,0,0,0,0,0,2,2,4,0,1,0,25,50,50
"17","10001","5",0,0,0,0,0,48,0,0,0,0,49,0,0,0,0,0,50,50,100,0,97,0,97,50,50
"18","10001","6",0,0,0,0,0,190,0,0,0,0,190,0,0,0,0,0,191,192,383,0,380,0,99.2167101827676,50.1305483028721,49.8694516971279
"19","11","1",7,7,11,9,14,32,11,3,8,13,35,5,7,7,3,3,97,81,178,10,67,5.61797752808989,37.6404494382022,45.5056179775281,54.4943820224719
"20","11","2",0,0,6,5,7,43,15,3,0,11,44,13,3,15,3,2,80,93,173,2,87,1.15606936416185,50.2890173410405,53.757225433526,46.242774566474
"21","11","3",0,0,1,0,1,100,7,0,0,1,100,7,0,7,0,0,110,117,227,0,200,0,88.1057268722467,51.5418502202643,48.4581497797357
"22","11","4",0,0,2,1,2,125,5,0,0,3,124,4,1,4,0,0,136,138,274,0,249,0,90.8759124087591,50.3649635036496,49.6350364963504
"23","11","5",0,0,1,0,1,126,0,0,0,1,125,0,0,0,0,0,129,128,257,0,251,0,97.6653696498054,49.8054474708171,50.1945525291829
"24","11","6",0,1,4,0,2,102,3,0,0,3,100,3,1,1,0,0,113,110,223,0,202,0,90.5829596412556,49.3273542600897,50.6726457399103
"25","12","1",2,4,4,3,6,16,2,4,4,3,18,3,0,5,4,4,42,43,85,6,34,7.05882352941176,40,50.5882352941176,49.4117647058824
"26","12","2",0,1,2,1,2,13,9,2,1,2,14,10,1,10,2,1,32,42,74,1,27,1.35135135135135,36.4864864864865,56.7567567567568,43.2432432432432
"27","12","3",0,0,1,0,1,13,14,5,0,1,13,19,0,18,5,0,35,58,93,0,26,0,27.9569892473118,62.3655913978495,37.6344086021505
"28","12","4",1,3,1,3,0,4,8,10,3,1,3,15,4,14,10,9,31,61,92,10,7,10.8695652173913,7.60869565217391,66.304347826087,33.695652173913
"29","12","5",0,0,0,0,0,24,4,4,0,0,24,8,0,8,4,1,33,47,80,1,48,1.25,60,58.75,41.25
"30","12","6",0,1,2,1,3,12,10,2,1,2,12,11,0,11,1,8,31,49,80,8,24,10,30,61.25,38.75
"31","13","1",2,2,10,1,7,19,5,0,2,9,17,4,3,2,0,0,48,38,86,2,36,2.32558139534884,41.8604651162791,44.1860465116279,55.8139534883721
"32","13","2",8,4,3,6,4,2,3,6,4,5,3,3,5,4,6,1,38,32,70,9,5,12.8571428571429,7.14285714285714,45.7142857142857,54.2857142857143
"33","13","3",1,3,3,4,2,4,5,1,3,4,3,2,4,2,1,0,24,21,45,1,7,2.22222222222222,15.5555555555556,46.6666666666667,53.3333333333333
"34","13","4",1,2,2,0,2,12,2,0,2,1,11,2,1,1,0,0,23,19,42,1,23,2.38095238095238,54.7619047619048,45.2380952380952,54.7619047619048
"35","13","5",0,0,2,0,2,19,1,0,0,2,19,1,0,1,0,0,25,25,50,0,38,0,76,50,50
"36","13","6",1,0,2,2,2,3,4,0,1,4,3,2,2,2,0,0,17,14,31,1,6,3.2258064516129,19.3548387096774,45.1612903225806,54.8387096774194
"37","14","1",2,8,13,3,11,18,7,4,8,9,16,8,6,5,4,2,68,59,127,4,34,3.1496062992126,26.7716535433071,46.4566929133858,53.5433070866142
"38","14","2",5,7,10,5,11,11,3,4,7,8,12,3,3,4,4,3,57,46,103,8,23,7.76699029126214,22.3300970873786,44.6601941747573,55.3398058252427
"39","14","3",1,3,7,3,8,23,4,2,3,7,24,3,2,4,2,0,53,46,99,1,47,1.01010101010101,47.4747474747475,46.4646464646465,53.5353535353535
"40","14","4",4,1,2,1,1,1,2,0,1,3,0,1,2,0,0,0,14,8,22,4,1,18.1818181818182,4.54545454545455,36.3636363636364,63.6363636363636
"41","14","5",3,2,0,1,0,0,2,0,2,0,0,0,2,0,0,0,10,5,15,3,0,20,0,33.3333333333333,66.6666666666667
"42","14","6",1,2,1,3,2,4,1,3,1,2,5,2,1,3,3,4,18,23,41,5,9,12.1951219512195,21.9512195121951,56.0975609756098,43.9024390243902
"43","15","1",0,0,0,0,0,0,0,0,0,0,0,0,0,0,0,0,0,0,0,0,0,NA,NA,NA,NA
"44","15","2",0,0,0,0,0,0,1,0,0,1,0,0,1,0,0,0,3,3,6,0,0,0,0,50,50
"45","15","3",0,0,0,0,0,0,0,0,0,0,0,0,0,0,0,0,1,0,1,0,0,0,0,0,100
"46","15","4",0,1,0,0,0,0,0,1,1,0,0,0,1,0,1,0,4,4,8,0,0,0,0,50,50
"47","15","5",0,0,0,0,0,3,0,0,0,0,4,0,0,0,0,0,5,5,10,0,7,0,70,50,50
"48","15","6",9,0,3,0,2,6,2,1,1,3,5,2,2,1,1,2,26,17,43,11,11,25.5813953488372,25.5813953488372,39.5348837209302,60.4651162790698
"49","16","1",17,11,26,2,26,8,2,1,12,17,8,0,3,0,1,0,96,41,137,17,16,12.4087591240876,11.6788321167883,29.9270072992701,70.0729927007299
"50","16","2",7,11,21,2,19,16,3,1,11,13,14,2,4,0,1,0,82,46,128,7,30,5.46875,23.4375,35.9375,64.0625
"51","16","3",8,10,32,1,34,9,0,1,10,24,10,0,0,1,1,0,97,47,144,8,19,5.55555555555556,13.1944444444444,32.6388888888889,67.3611111111111
"52","16","4",3,5,22,1,22,29,1,0,5,18,29,0,1,0,0,0,85,54,139,3,58,2.15827338129496,41.726618705036,38.8489208633094,61.1510791366906
"53","16","5",7,4,5,1,6,9,2,0,4,2,9,1,1,1,0,0,36,19,55,7,18,12.7272727272727,32.7272727272727,34.5454545454545,65.4545454545455
"54","16","6",0,0,2,2,3,4,4,0,0,4,5,2,2,3,0,0,17,17,34,0,9,0,26.4705882352941,50,50
"55","17","1",3,4,3,5,3,16,6,4,4,4,16,4,5,5,4,6,45,50,95,9,32,9.47368421052632,33.6842105263158,52.6315789473684,47.3684210526316
"56","17","2",1,1,6,3,8,33,8,1,1,8,36,6,1,8,1,4,63,66,129,5,69,3.87596899224806,53.4883720930233,51.1627906976744,48.8372093023256
"57","17","3",0,0,2,2,3,43,11,2,0,4,45,11,1,12,2,1,65,77,142,1,88,0.704225352112676,61.9718309859155,54.2253521126761,45.7746478873239
"58","17","4",3,2,6,2,6,35,7,1,2,7,35,6,3,5,1,1,64,61,125,4,70,3.2,56,48.8,51.2
"59","17","5",0,0,5,0,4,29,4,0,0,5,28,4,1,3,0,0,43,43,86,0,57,0,66.2790697674419,50,50
"60","17","6",0,0,0,4,4,15,4,1,0,5,19,1,1,4,1,1,30,33,63,1,34,1.58730158730159,53.968253968254,52.3809523809524,47.6190476190476
"61","18","1",4,2,7,1,6,17,5,3,2,5,16,7,1,7,3,5,46,48,94,9,33,9.57446808510638,35.1063829787234,51.063829787234,48.936170212766
"62","18","2",0,1,3,2,2,40,12,0,1,4,39,10,3,9,0,0,62,67,129,0,79,0,61.2403100775194,51.937984496124,48.062015503876
"63","18","3",0,0,3,1,4,34,6,1,0,4,36,6,0,7,1,0,51,55,106,0,70,0,66.0377358490566,51.8867924528302,48.1132075471698
"64","18","4",0,0,4,0,3,31,7,1,0,4,30,8,1,7,1,0,47,53,100,0,61,0,61,53,47
"65","18","5",0,0,1,0,1,40,1,0,0,1,40,1,0,1,0,0,45,44,89,0,80,0,89.8876404494382,49.438202247191,50.561797752809
"66","18","6",0,0,1,2,2,26,3,2,0,3,27,3,1,4,2,0,38,41,79,0,53,0,67.0886075949367,51.8987341772152,48.1012658227848
"67","19","1",0,1,6,2,5,26,5,1,1,7,25,4,3,4,2,1,47,49,96,1,51,1.04166666666667,53.125,51.0416666666667,48.9583333333333
"68","19","2",0,1,9,1,8,28,5,0,1,9,26,4,2,3,0,0,53,47,100,0,54,0,54,47,53
"69","19","3",0,1,1,1,1,25,9,1,1,1,26,9,1,9,1,0,41,49,90,0,51,0,56.6666666666667,54.4444444444444,45.5555555555556
"70","19","4",0,1,5,1,7,33,3,0,1,5,35,2,0,3,0,0,52,47,99,0,68,0,68.6868686868687,47.4747474747475,52.5252525252525
"71","19","5",0,1,6,0,4,25,5,0,1,5,24,5,2,4,0,0,43,42,85,0,49,0,57.6470588235294,49.4117647058824,50.5882352941176
"72","19","6",0,0,0,2,2,31,2,1,0,2,33,1,0,3,1,0,39,42,81,0,64,0,79.0123456790123,51.8518518518519,48.1481481481481
"73","2","1",5,4,3,6,6,12,8,3,4,5,14,5,3,7,2,1,47,44,91,6,26,6.59340659340659,28.5714285714286,48.3516483516484,51.6483516483516
"74","2","2",1,2,1,3,1,6,5,3,2,3,6,4,4,4,3,1,24,28,52,2,12,3.84615384615385,23.0769230769231,53.8461538461538,46.1538461538462
"75","2","3",2,1,2,1,2,2,2,0,1,2,2,1,1,1,0,0,14,9,23,2,4,8.69565217391304,17.3913043478261,39.1304347826087,60.8695652173913
"76","2","4",0,1,2,0,1,5,0,1,0,1,4,2,0,1,1,2,11,13,24,2,9,8.33333333333333,37.5,54.1666666666667,45.8333333333333
"77","2","5",0,1,5,2,4,34,3,1,1,6,33,2,3,1,1,0,51,49,100,0,67,0,67,49,51
"78","2","6",0,0,2,0,2,29,2,0,0,2,29,1,0,2,0,0,36,36,72,0,58,0,80.5555555555556,50,50
"79","20","1",1,3,8,3,9,20,5,3,2,8,21,5,1,7,3,0,53,49,102,1,41,0.980392156862745,40.1960784313725,48.0392156862745,51.9607843137255
"80","20","2",21,11,22,1,24,15,3,0,11,12,17,2,0,3,0,0,99,46,145,21,32,14.4827586206897,22.0689655172414,31.7241379310345,68.2758620689655
"81","20","3",19,18,31,2,31,11,2,0,18,15,11,0,2,0,0,0,116,47,163,19,22,11.6564417177914,13.4969325153374,28.8343558282209,71.1656441717791
"82","20","4",0,2,27,1,28,66,0,0,2,26,67,0,0,0,0,0,125,97,222,0,133,0,59.9099099099099,43.6936936936937,56.3063063063063
"83","20","5",0,0,9,1,10,97,1,0,0,10,97,0,0,0,0,0,119,109,228,0,194,0,85.0877192982456,47.8070175438597,52.1929824561403
"84","20","6",2,5,29,3,32,62,2,1,5,27,64,0,1,2,1,0,138,101,239,2,126,0.836820083682008,52.7196652719665,42.2594142259414,57.7405857740586
"85","21","1",0,2,4,0,4,15,1,1,2,2,16,2,0,2,1,2,29,28,57,2,31,3.50877192982456,54.3859649122807,49.1228070175439,50.8771929824561
"86","21","2",0,0,4,0,3,13,3,1,0,4,12,5,1,3,1,0,25,28,53,0,25,0,47.1698113207547,52.8301886792453,47.1698113207547
"87","21","3",0,0,0,1,1,4,8,5,0,1,5,11,0,13,5,3,20,40,60,3,9,5,15,66.6666666666667,33.3333333333333
"88","21","4",0,0,1,0,1,37,6,0,0,1,37,6,0,6,0,0,46,52,98,0,74,0,75.5102040816327,53.0612244897959,46.9387755102041
"89","21","5",0,0,3,1,1,34,8,2,0,4,32,9,3,7,2,2,51,60,111,2,66,1.8018018018018,59.4594594594595,54.0540540540541,45.9459459459459
"90","21","6",0,0,0,0,0,43,14,0,0,0,44,14,0,14,0,0,59,73,132,0,87,0,65.9090909090909,55.3030303030303,44.6969696969697
"91","22","1",1,1,1,3,2,10,4,2,1,3,12,3,2,5,3,6,26,36,62,7,22,11.2903225806452,35.4838709677419,58.0645161290323,41.9354838709677
"92","22","2",0,0,7,1,7,41,8,1,0,8,42,8,1,8,1,0,67,69,136,0,83,0,61.0294117647059,50.7352941176471,49.2647058823529
"93","22","3",1,1,2,1,2,61,3,0,1,3,61,2,2,1,0,0,73,71,144,1,122,0.694444444444444,84.7222222222222,49.3055555555556,50.6944444444444
"94","22","4",0,0,3,0,1,57,3,0,0,3,54,3,2,1,0,0,65,65,130,0,111,0,85.3846153846154,50,50
"95","22","5",0,0,2,1,2,56,1,1,0,3,57,1,1,1,1,0,65,65,130,0,113,0,86.9230769230769,50,50
"96","22","6",0,0,1,0,1,26,1,0,0,1,27,1,0,1,0,0,31,31,62,0,53,0,85.4838709677419,50,50
"97","23","1",4,2,4,4,6,7,5,4,2,6,8,5,2,7,4,2,37,38,75,6,15,8,20,50.6666666666667,49.3333333333333
"98","23","2",1,3,11,6,14,22,7,0,2,14,26,1,2,5,0,0,66,51,117,1,48,0.854700854700855,41.025641025641,43.5897435897436,56.4102564102564
"99","23","3",0,1,5,6,9,53,10,0,1,10,58,4,2,8,0,0,86,84,170,0,111,0,65.2941176470588,49.4117647058824,50.5882352941176
"100","23","4",0,0,7,2,6,60,8,0,0,9,58,6,3,5,0,0,84,83,167,0,118,0,70.6586826347305,49.7005988023952,50.2994011976048
"101","23","5",0,0,4,0,1,67,4,1,0,4,63,5,3,2,1,4,78,84,162,4,130,2.46913580246914,80.2469135802469,51.8518518518519,48.1481481481481
"102","23","6",1,2,5,7,7,35,9,0,2,10,37,2,5,4,0,0,68,61,129,1,72,0.775193798449612,55.8139534883721,47.2868217054264,52.7131782945736
"103","24","1",3,3,6,4,5,17,4,6,3,7,17,6,5,5,6,10,50,60,110,13,34,11.8181818181818,30.9090909090909,54.5454545454545,45.4545454545455
"104","24","2",0,0,6,3,6,50,4,4,0,9,50,5,3,4,3,2,73,79,152,2,100,1.31578947368421,65.7894736842105,51.9736842105263,48.0263157894737
"105","24","3",0,0,11,0,9,62,3,0,0,11,60,3,2,1,0,0,87,78,165,0,122,0,73.9393939393939,47.2727272727273,52.7272727272727
"106","24","4",1,1,7,1,5,38,6,0,1,7,36,5,3,3,0,0,60,57,117,1,74,0.854700854700855,63.2478632478633,48.7179487179487,51.2820512820513
"107","24","5",0,0,5,0,3,38,6,0,0,5,36,5,2,4,0,0,53,54,107,0,74,0,69.1588785046729,50.4672897196262,49.5327102803738
"108","24","6",0,0,2,0,0,48,2,1,0,2,45,3,2,1,1,1,54,57,111,1,93,0.900900900900901,83.7837837837838,51.3513513513514,48.6486486486486
"109","25","1",0,0,6,3,5,38,12,1,0,10,37,10,5,8,1,1,67,73,140,1,75,0.714285714285714,53.5714285714286,52.1428571428571,47.8571428571429
"110","25","2",0,1,6,3,5,29,12,1,1,7,29,10,3,10,1,0,59,62,121,0,58,0,47.9338842975207,51.2396694214876,48.7603305785124
"111","25","3",0,0,4,3,3,34,13,0,0,7,33,10,4,8,0,0,58,64,122,0,67,0,54.9180327868852,52.4590163934426,47.5409836065574
"112","25","4",0,0,2,7,6,37,10,0,0,10,41,3,4,6,0,0,64,65,129,0,78,0,60.4651162790698,50.3875968992248,49.6124031007752
"113","25","5",0,0,5,6,4,47,10,0,0,11,46,4,6,4,0,0,73,73,146,0,93,0,63.6986301369863,50,50
"114","25","6",3,3,9,6,11,67,12,0,3,12,68,7,4,8,0,0,112,104,216,3,135,1.38888888888889,62.5,48.1481481481481,51.8518518518519
"115","26","1",2,4,2,5,2,19,13,10,3,3,19,18,4,19,10,6,58,84,142,8,38,5.63380281690141,26.7605633802817,59.1549295774648,40.8450704225352
"116","26","2",0,1,0,2,1,28,24,9,1,1,29,31,1,32,9,5,66,111,177,5,57,2.82485875706215,32.2033898305085,62.7118644067797,37.2881355932203
"117","26","3",0,0,0,1,1,68,12,0,0,1,68,11,0,12,0,0,83,94,177,0,136,0,76.8361581920904,53.1073446327684,46.8926553672316
"118","26","4",0,0,2,4,6,71,5,2,0,6,75,3,0,7,2,2,92,96,188,2,146,1.06382978723404,77.6595744680851,51.063829787234,48.936170212766
"119","26","5",0,0,6,1,5,47,4,0,0,7,46,3,2,2,0,0,64,62,126,0,93,0,73.8095238095238,49.2063492063492,50.7936507936508
"120","26","6",9,7,10,5,9,24,6,3,7,8,23,4,5,4,3,0,74,56,130,9,47,6.92307692307692,36.1538461538462,43.0769230769231,56.9230769230769
"121","27","1",5,6,5,5,6,12,8,8,5,4,13,11,3,13,8,8,56,67,123,13,25,10.5691056910569,20.3252032520325,54.4715447154472,45.5284552845528
"122","27","2",0,4,3,3,4,19,10,3,4,2,20,11,2,12,4,5,47,62,109,5,39,4.58715596330275,35.7798165137615,56.8807339449541,43.1192660550459
"123","27","3",3,6,7,6,9,2,7,4,5,7,4,5,4,7,4,1,46,38,84,4,6,4.76190476190476,7.14285714285714,45.2380952380952,54.7619047619048
"124","27","4",0,2,3,1,2,14,4,5,2,2,13,9,2,7,5,1,32,43,75,1,27,1.33333333333333,36,57.3333333333333,42.6666666666667
"125","27","5",0,0,4,3,6,19,10,1,0,8,21,7,2,9,1,0,45,49,94,0,40,0,42.5531914893617,52.1276595744681,47.8723404255319
"126","27","6",5,3,8,1,10,22,1,0,4,6,23,0,0,1,0,0,53,34,87,5,45,5.74712643678161,51.7241379310345,39.0804597701149,60.9195402298851
"127","28","1",0,7,15,4,16,13,3,4,7,12,14,3,4,4,5,7,64,57,121,7,27,5.78512396694215,22.3140495867769,47.1074380165289,52.8925619834711
"128","28","2",9,10,26,2,27,17,2,1,10,19,18,0,2,1,1,2,96,54,150,11,35,7.33333333333333,23.3333333333333,36,64
"129","28","3",21,16,17,2,16,2,2,1,15,3,2,1,2,1,1,0,79,26,105,21,4,20,3.80952380952381,24.7619047619048,75.2380952380952
"130","28","4",9,4,6,3,6,4,2,1,4,5,4,0,3,0,1,0,37,18,55,9,8,16.3636363636364,14.5454545454545,32.7272727272727,67.2727272727273
"131","28","5",1,4,13,0,13,11,0,1,5,9,11,1,1,1,1,1,46,30,76,2,22,2.63157894736842,28.9473684210526,39.4736842105263,60.5263157894737
"132","28","6",1,2,6,1,6,10,1,1,2,5,10,1,1,1,1,0,30,22,52,1,20,1.92307692307692,38.4615384615385,42.3076923076923,57.6923076923077
"133","29","1",10,7,14,2,12,22,4,2,7,9,20,4,4,3,2,1,74,52,126,11,42,8.73015873015873,33.3333333333333,41.2698412698413,58.7301587301587
"134","29","2",2,4,11,0,11,30,4,1,3,7,30,5,0,5,1,0,65,52,117,2,60,1.70940170940171,51.2820512820513,44.4444444444444,55.5555555555556
"135","29","3",0,0,2,1,2,31,8,1,0,3,32,8,1,8,1,0,47,54,101,0,63,0,62.3762376237624,53.4653465346535,46.5346534653465
"136","29","4",1,1,3,9,8,13,10,0,1,11,18,1,4,6,0,0,46,43,89,1,31,1.12359550561798,34.8314606741573,48.314606741573,51.685393258427
"137","29","5",3,3,5,5,9,38,6,1,3,7,43,1,1,6,1,1,72,64,136,4,81,2.94117647058824,59.5588235294118,47.0588235294118,52.9411764705882
"138","29","6",5,2,8,2,7,18,6,1,2,8,17,5,3,4,1,0,50,42,92,5,35,5.43478260869565,38.0434782608696,45.6521739130435,54.3478260869565
"139","3","1",1,3,7,4,4,27,8,3,3,8,25,7,6,5,3,0,59,58,117,1,52,0.854700854700855,44.4444444444444,49.5726495726496,50.4273504273504
"140","3","2",0,0,4,3,3,38,12,0,0,7,38,9,4,8,0,0,62,67,129,0,76,0,58.9147286821705,51.937984496124,48.062015503876
"141","3","3",0,1,4,7,7,39,10,2,1,10,42,5,3,9,2,0,71,74,145,0,81,0,55.8620689655172,51.0344827586207,48.9655172413793
"142","3","4",0,0,3,8,7,45,11,0,0,11,48,3,4,7,0,0,75,75,150,0,93,0,62,50,50
"143","3","5",0,0,0,1,1,91,1,0,0,1,92,0,0,1,0,0,96,95,191,0,183,0,95.8115183246073,49.738219895288,50.261780104712
"144","3","6",0,0,1,0,1,113,1,0,0,1,114,1,0,1,0,0,118,118,236,0,227,0,96.1864406779661,50,50
"145","30","1",12,7,9,6,10,15,5,4,6,9,16,3,5,4,4,8,70,56,126,20,31,15.8730158730159,24.6031746031746,44.4444444444444,55.5555555555556
"146","30","2",2,2,6,5,5,32,9,2,3,9,30,6,7,4,2,0,66,61,127,2,62,1.5748031496063,48.8188976377953,48.0314960629921,51.9685039370079
"147","30","3",2,2,6,6,8,37,10,1,2,10,38,5,4,7,1,1,73,70,143,3,75,2.0979020979021,52.4475524475524,48.951048951049,51.048951048951
"148","30","4",0,0,6,8,4,22,12,1,0,14,19,5,10,3,1,0,54,54,108,0,41,0,37.962962962963,50,50
"149","30","5",0,0,5,3,5,30,8,0,0,8,30,5,3,5,0,0,53,52,105,0,60,0,57.1428571428571,49.5238095238095,50.4761904761905
"150","30","6",3,1,2,3,5,15,4,2,2,4,18,3,1,5,2,1,38,36,74,4,33,5.40540540540541,44.5945945945946,48.6486486486486,51.3513513513514
"151","31","1",7,6,8,4,6,16,5,4,6,6,14,5,6,4,5,2,57,50,107,9,30,8.41121495327103,28.0373831775701,46.7289719626168,53.2710280373832
"152","31","2",0,0,5,6,7,14,8,1,0,11,15,3,4,5,1,0,42,41,83,0,29,0,34.9397590361446,49.3975903614458,50.6024096385542
"153","31","3",1,2,13,1,12,29,1,1,2,11,29,1,1,1,1,0,62,47,109,1,58,0.917431192660551,53.2110091743119,43.1192660550459,56.8807339449541
"154","31","4",4,5,7,0,6,10,2,2,5,2,10,4,1,3,2,0,38,28,66,4,20,6.06060606060606,30.3030303030303,42.4242424242424,57.5757575757576
"155","31","5",3,3,4,1,3,47,3,0,3,2,47,1,2,1,0,0,66,57,123,3,94,2.4390243902439,76.4227642276423,46.3414634146341,53.6585365853659
"156","31","6",8,1,6,2,8,13,4,0,1,7,15,2,1,3,0,0,44,30,74,8,28,10.8108108108108,37.8378378378378,40.5405405405405,59.4594594594595
"157","32","1",3,1,8,3,9,41,6,3,1,10,42,6,2,8,4,9,75,84,159,12,83,7.54716981132075,52.2012578616352,52.8301886792453,47.1698113207547
"158","32","2",8,7,12,0,11,31,10,1,7,5,31,11,1,10,1,0,82,67,149,8,62,5.36912751677852,41.6107382550336,44.9664429530201,55.0335570469799
"159","32","3",0,0,6,2,5,81,3,2,0,8,80,4,3,2,2,0,100,101,201,0,161,0,80.0995024875622,50.2487562189055,49.7512437810945
"160","32","4",0,1,4,0,4,84,1,0,1,3,84,1,0,1,0,0,96,91,187,0,168,0,89.8395721925134,48.6631016042781,51.3368983957219
"161","32","5",0,0,3,0,1,74,2,1,0,3,72,3,2,1,1,0,82,84,166,0,146,0,87.9518072289157,50.6024096385542,49.3975903614458
"162","32","6",1,1,5,1,2,49,5,0,1,6,45,4,5,0,0,0,66,62,128,1,94,0.78125,73.4375,48.4375,51.5625
"163","33","1",4,3,3,0,1,5,1,3,3,1,3,4,2,2,3,2,22,21,43,6,8,13.953488372093,18.6046511627907,48.8372093023256,51.1627906976744
"164","33","2",2,4,1,3,3,0,1,7,4,1,2,5,2,6,7,2,23,30,53,4,2,7.54716981132075,3.77358490566038,56.6037735849057,43.3962264150943
"165","33","3",1,2,3,6,6,13,6,2,2,7,17,1,3,5,2,0,41,38,79,1,30,1.26582278481013,37.9746835443038,48.1012658227848,51.8987341772152
"166","33","4",0,2,3,1,3,50,2,1,1,2,50,2,1,2,1,1,64,61,125,1,100,0.8,80,48.8,51.2
"167","33","5",2,3,5,0,5,29,1,0,3,2,29,1,0,1,0,0,47,37,84,2,58,2.38095238095238,69.0476190476191,44.0476190476191,55.9523809523809
"168","33","6",1,0,2,0,3,44,0,0,1,2,45,0,0,0,0,0,53,48,101,1,89,0.99009900990099,88.1188118811881,47.5247524752475,52.4752475247525
"169","34","1",4,1,8,3,8,32,4,0,1,10,33,1,3,1,0,0,62,50,112,4,65,3.57142857142857,58.0357142857143,44.6428571428571,55.3571428571429
"170","34","2",0,0,21,3,22,48,3,1,0,24,50,1,1,3,1,0,100,81,181,0,98,0,54.1436464088398,44.7513812154696,55.2486187845304
"171","34","3",0,1,7,1,7,63,4,0,1,7,63,3,1,3,0,0,84,80,164,0,126,0,76.8292682926829,48.780487804878,51.219512195122
"172","34","4",0,1,6,1,4,43,5,0,1,6,42,4,3,2,0,0,62,59,121,0,85,0,70.2479338842975,48.7603305785124,51.2396694214876
"173","34","5",0,0,0,3,3,42,5,1,0,3,45,3,0,6,1,1,55,61,116,1,87,0.862068965517241,75,52.5862068965517,47.4137931034483
"174","34","6",0,0,2,1,2,39,2,0,0,3,39,1,0,2,0,0,47,47,94,0,78,0,82.9787234042553,50,50
"175","35","1",0,0,4,2,3,23,8,0,0,5,22,6,2,6,0,0,41,43,84,0,45,0,53.5714285714286,51.1904761904762,48.8095238095238
"176","35","2",1,1,2,0,2,63,5,0,1,1,64,5,0,5,0,0,76,77,153,1,127,0.65359477124183,83.0065359477124,50.3267973856209,49.6732026143791
"177","35","3",0,0,3,0,3,59,3,0,0,3,60,3,0,3,0,0,70,70,140,0,119,0,85,50,50
"178","35","4",0,0,0,3,1,32,6,0,0,3,34,3,1,5,0,0,44,47,91,0,66,0,72.5274725274725,51.6483516483516,48.3516483516484
"179","35","5",0,0,1,1,2,26,2,0,0,2,28,1,0,2,0,0,34,34,68,0,54,0,79.4117647058823,50,50
"180","35","6",0,0,0,1,1,39,0,0,0,1,40,0,0,0,0,0,42,43,85,0,79,0,92.9411764705882,50.5882352941176,49.4117647058824
"181","36","1",7,3,3,4,4,36,4,4,3,3,37,4,3,5,4,3,67,63,130,10,73,7.69230769230769,56.1538461538462,48.4615384615385,51.5384615384615
"182","36","2",3,7,24,2,25,27,4,1,7,19,28,2,2,3,1,2,95,65,160,5,55,3.125,34.375,40.625,59.375
"183","36","3",8,8,21,2,21,27,2,0,8,15,28,0,1,1,0,0,91,54,145,8,55,5.51724137931035,37.9310344827586,37.2413793103448,62.7586206896552
"184","36","4",0,0,11,4,8,55,9,0,0,15,53,5,7,2,0,0,89,83,172,0,108,0,62.7906976744186,48.2558139534884,51.7441860465116
"185","36","5",0,0,10,3,11,41,6,1,0,13,42,4,2,4,1,0,73,68,141,0,83,0,58.8652482269504,48.2269503546099,51.7730496453901
"186","36","6",0,0,3,2,2,14,8,6,0,5,14,12,3,12,6,1,37,54,91,1,28,1.0989010989011,30.7692307692308,59.3406593406593,40.6593406593407
"187","37","1",1,2,5,3,4,34,9,5,2,7,33,11,5,10,6,6,65,81,146,7,67,4.79452054794521,45.8904109589041,55.4794520547945,44.5205479452055
"188","37","2",6,2,6,3,5,32,14,5,2,7,30,16,4,14,4,2,73,82,155,8,62,5.16129032258065,40,52.9032258064516,47.0967741935484
"189","37","3",1,1,0,2,2,62,11,1,1,1,64,10,0,12,1,0,81,91,172,1,126,0.581395348837209,73.2558139534884,52.906976744186,47.093023255814
"190","37","4",0,1,4,0,4,50,5,2,1,3,50,7,0,7,2,2,67,74,141,2,100,1.41843971631206,70.9219858156028,52.4822695035461,47.5177304964539
"191","37","5",0,1,6,1,6,51,3,0,1,6,51,2,1,2,0,0,70,64,134,0,102,0,76.1194029850746,47.7611940298507,52.2388059701493
"192","37","6",0,0,2,0,2,23,3,0,0,2,23,3,1,2,0,0,32,32,64,0,46,0,71.875,50,50
"193","38","1",0,3,6,3,7,26,5,1,3,6,27,3,2,4,1,0,52,48,100,0,53,0,53,48,52
"194","38","2",1,1,1,6,1,8,14,8,1,6,8,16,6,16,8,3,41,66,107,4,16,3.73831775700935,14.9532710280374,61.6822429906542,38.3177570093458
"195","38","3",0,0,2,3,4,32,20,5,0,5,35,22,1,25,6,3,68,98,166,3,67,1.80722891566265,40.3614457831325,59.0361445783133,40.9638554216867
"196","38","4",0,2,19,4,19,40,4,2,2,21,40,2,4,2,2,2,91,77,168,2,80,1.19047619047619,47.6190476190476,45.8333333333333,54.1666666666667
"197","38","5",0,0,9,2,10,63,2,0,0,10,65,0,0,2,0,0,88,78,166,0,128,0,77.1084337349398,46.9879518072289,53.0120481927711
"198","38","6",0,1,7,0,6,67,2,0,1,6,66,2,1,1,0,0,84,79,163,0,133,0,81.5950920245399,48.4662576687117,51.5337423312883
"199","39","1",1,3,4,3,1,6,2,5,3,4,3,4,6,1,5,13,27,40,67,14,9,20.8955223880597,13.4328358208955,59.7014925373134,40.2985074626866
"200","39","2",1,2,7,4,8,11,4,3,2,9,13,3,3,5,3,1,42,40,82,2,24,2.4390243902439,29.2682926829268,48.780487804878,51.219512195122
"201","39","3",6,3,9,2,7,28,8,1,3,8,27,7,4,5,1,0,66,56,122,6,55,4.91803278688525,45.0819672131148,45.9016393442623,54.0983606557377
"202","39","4",3,3,10,1,9,28,5,1,3,8,28,4,2,4,1,1,62,52,114,4,56,3.50877192982456,49.1228070175439,45.6140350877193,54.3859649122807
"203","39","5",0,3,8,3,6,21,6,0,3,8,19,3,5,2,0,0,48,42,90,0,40,0,44.4444444444444,46.6666666666667,53.3333333333333
"204","39","6",9,5,6,1,6,18,6,1,5,2,17,6,1,6,1,0,53,40,93,9,35,9.67741935483871,37.6344086021505,43.010752688172,56.989247311828
"205","4","1",4,4,5,2,4,13,6,3,4,3,13,7,3,6,3,4,43,44,87,8,26,9.19540229885057,29.8850574712644,50.5747126436782,49.4252873563218
"206","4","2",4,5,3,3,3,3,2,2,5,1,2,2,3,1,2,0,26,18,44,4,5,9.09090909090909,11.3636363636364,40.9090909090909,59.0909090909091
"207","4","3",7,3,4,2,3,7,1,3,2,3,6,2,2,1,2,2,30,23,53,9,13,16.9811320754717,24.5283018867925,43.3962264150943,56.6037735849057
"208","4","4",1,1,7,0,5,13,4,1,1,6,10,5,3,2,1,0,34,29,63,1,23,1.58730158730159,36.5079365079365,46.031746031746,53.968253968254
"209","4","5",3,2,1,3,2,6,4,2,2,1,7,3,1,4,2,0,24,22,46,3,13,6.52173913043478,28.2608695652174,47.8260869565217,52.1739130434783
"210","4","6",0,2,7,0,5,14,4,4,2,5,12,7,2,6,4,6,37,46,83,6,26,7.2289156626506,31.3253012048193,55.421686746988,44.578313253012
"211","40","1",1,2,1,1,1,3,2,1,2,0,3,2,1,1,1,0,13,12,25,1,6,4,24,48,52
"212","40","2",6,4,2,3,4,3,3,2,4,1,6,2,1,5,3,1,29,24,53,7,9,13.2075471698113,16.9811320754717,45.2830188679245,54.7169811320755
"213","40","3",0,1,6,3,6,37,6,0,1,8,37,3,3,3,0,0,60,57,117,0,74,0,63.2478632478633,48.7179487179487,51.2820512820513
"214","40","4",2,1,2,2,4,46,4,0,1,3,47,2,1,3,0,0,63,58,121,2,93,1.65289256198347,76.8595041322314,47.9338842975207,52.0661157024793
"215","40","5",2,2,1,3,3,41,3,1,2,2,43,1,1,3,0,2,56,57,113,4,84,3.53982300884956,74.3362831858407,50.4424778761062,49.5575221238938
"216","40","6",2,2,3,4,3,25,5,2,2,5,25,4,4,4,3,0,47,49,96,2,50,2.08333333333333,52.0833333333333,51.0416666666667,48.9583333333333
"217","41","1",3,4,6,5,7,9,12,6,4,7,10,13,4,14,6,10,53,70,123,13,19,10.5691056910569,15.4471544715447,56.9105691056911,43.0894308943089
"218","41","2",0,0,7,4,8,22,11,1,0,11,24,8,3,10,1,0,55,58,113,0,46,0,40.7079646017699,51.3274336283186,48.6725663716814
"219","41","3",1,2,3,2,3,40,7,2,2,3,40,8,1,8,2,0,61,66,127,1,80,0.78740157480315,62.992125984252,51.9685039370079,48.0314960629921
"220","41","4",0,0,3,2,4,50,9,1,0,5,52,8,1,9,1,0,71,77,148,0,102,0,68.9189189189189,52.027027027027,47.972972972973
"221","41","5",0,0,0,1,1,59,1,2,0,1,60,2,0,3,2,1,65,71,136,1,119,0.735294117647059,87.5,52.2058823529412,47.7941176470588
"222","41","6",3,3,3,0,2,24,1,0,3,0,22,1,1,0,0,0,37,29,66,3,46,4.54545454545455,69.6969696969697,43.9393939393939,56.0606060606061
"223","42","1",7,3,7,6,6,24,24,3,3,10,23,21,7,20,3,2,81,91,172,9,47,5.23255813953488,27.3255813953488,52.906976744186,47.093023255814
"224","42","2",0,1,4,5,7,29,19,3,1,8,33,17,2,20,3,4,70,89,159,4,62,2.51572327044025,38.9937106918239,55.9748427672956,44.0251572327044
"225","42","3",0,1,3,6,3,48,23,1,1,8,48,18,5,18,1,0,86,101,187,0,96,0,51.3368983957219,54.0106951871658,45.9893048128342
"226","42","4",1,1,1,2,2,53,16,2,1,2,54,16,1,17,2,0,79,95,174,1,107,0.574712643678161,61.4942528735632,54.5977011494253,45.4022988505747
"227","42","5",2,1,4,1,5,76,7,0,1,4,76,6,1,6,0,0,98,95,193,2,152,1.03626943005181,78.7564766839378,49.2227979274611,50.7772020725389
"228","42","6",5,5,5,3,6,22,2,4,4,3,23,4,1,5,4,2,53,48,101,7,45,6.93069306930693,44.5544554455446,47.5247524752475,52.4752475247525
"229","43","1",0,1,9,3,11,36,7,2,1,11,38,6,1,8,2,1,70,70,140,1,74,0.714285714285714,52.8571428571429,50,50
"230","43","2",0,0,2,6,7,38,12,0,0,8,43,6,0,11,0,0,66,70,136,0,81,0,59.5588235294118,51.4705882352941,48.5294117647059
"231","43","3",0,0,2,3,4,26,13,0,0,5,28,10,1,13,1,0,49,60,109,0,54,0,49.5412844036697,55.045871559633,44.954128440367
"232","43","4",1,1,2,1,2,60,13,0,1,2,60,12,1,12,0,0,81,90,171,1,120,0.584795321637427,70.1754385964912,52.6315789473684,47.3684210526316
"233","43","5",0,0,4,2,4,53,10,0,0,6,54,8,2,8,0,0,75,79,154,0,107,0,69.4805194805195,51.2987012987013,48.7012987012987
"234","43","6",0,0,2,2,1,38,13,5,0,4,37,17,3,15,5,2,62,85,147,2,75,1.36054421768707,51.0204081632653,57.8231292517007,42.1768707482993
"235","44","1",4,2,6,5,6,13,6,6,2,9,13,7,5,7,6,5,50,55,105,9,26,8.57142857142857,24.7619047619048,52.3809523809524,47.6190476190476
"236","44","2",0,0,0,5,0,16,18,2,0,5,16,15,5,15,1,0,41,60,101,0,32,0,31.6831683168317,59.4059405940594,40.5940594059406
"237","44","3",1,2,2,2,1,18,22,5,2,2,16,25,3,24,5,1,54,80,134,2,34,1.49253731343284,25.3731343283582,59.7014925373134,40.2985074626866
"238","44","4",0,1,1,1,2,22,11,4,1,1,24,14,0,15,4,0,44,60,104,0,46,0,44.2307692307692,57.6923076923077,42.3076923076923
"239","44","5",0,1,2,0,1,45,10,1,1,1,44,11,1,11,1,0,61,72,133,0,89,0,66.9172932330827,54.1353383458647,45.8646616541353
"240","44","6",1,1,1,1,2,30,5,0,1,1,31,4,0,5,0,0,43,43,86,1,61,1.16279069767442,70.9302325581395,50,50
"241","45","1",7,3,6,5,7,13,6,6,3,8,15,7,3,9,6,10,55,62,117,17,28,14.5299145299145,23.9316239316239,52.991452991453,47.008547008547
"242","45","2",0,1,17,0,12,29,4,2,1,16,24,6,4,2,2,1,66,58,124,1,53,0.806451612903226,42.741935483871,46.7741935483871,53.2258064516129
"243","45","3",2,4,16,3,12,31,6,2,4,15,27,5,7,1,2,1,78,63,141,3,58,2.12765957446809,41.1347517730496,44.6808510638298,55.3191489361702
"244","45","4",0,0,14,0,12,49,5,0,0,13,48,5,1,4,0,0,82,72,154,0,97,0,62.987012987013,46.7532467532468,53.2467532467532
"245","45","5",1,1,2,1,2,58,8,0,1,2,58,7,1,7,0,0,75,77,152,1,116,0.657894736842105,76.3157894736842,50.6578947368421,49.3421052631579
"246","45","6",2,2,9,1,7,52,8,2,2,8,51,9,3,7,2,0,85,83,168,2,103,1.19047619047619,61.3095238095238,49.4047619047619,50.5952380952381
"247","46","1",1,4,15,5,16,54,8,3,4,16,55,6,4,7,3,1,108,97,205,2,109,0.975609756097561,53.1707317073171,47.3170731707317,52.6829268292683
"248","46","2",1,2,12,4,15,30,3,5,2,14,33,4,1,7,5,0,74,67,141,1,63,0.709219858156028,44.6808510638298,47.5177304964539,52.4822695035461
"249","46","3",0,0,7,5,7,26,11,4,0,12,25,10,5,10,4,1,61,69,130,1,51,0.769230769230769,39.2307692307692,53.0769230769231,46.9230769230769
"250","46","4",0,1,8,6,6,24,13,0,1,12,22,7,7,6,0,0,59,57,116,0,46,0,39.6551724137931,49.1379310344828,50.8620689655172
"251","46","5",0,2,4,9,10,154,11,3,2,11,160,5,3,11,3,1,195,197,392,1,314,0.255102040816327,80.1020408163265,50.2551020408163,49.7448979591837
"252","46","6",3,3,8,7,10,120,11,2,3,12,122,6,4,9,2,1,165,161,326,4,242,1.22699386503067,74.2331288343558,49.3865030674847,50.6134969325153
"253","47","1",3,5,6,5,7,22,10,5,4,6,24,10,3,12,5,3,65,68,133,6,46,4.51127819548872,34.5864661654135,51.1278195488722,48.8721804511278
"254","47","2",1,1,1,2,1,21,12,8,1,2,21,17,2,18,8,5,48,76,124,6,42,4.83870967741935,33.8709677419355,61.2903225806452,38.7096774193548
"255","47","3",0,1,3,3,5,25,16,1,1,5,27,13,1,16,1,0,55,66,121,0,52,0,42.9752066115703,54.5454545454545,45.4545454545455
"256","47","4",2,1,1,3,3,14,8,2,1,3,16,7,1,8,2,1,35,41,76,3,30,3.94736842105263,39.4736842105263,53.9473684210526,46.0526315789474
"257","47","5",0,0,1,1,1,30,11,5,0,2,30,15,1,14,5,2,50,71,121,2,60,1.65289256198347,49.5867768595041,58.6776859504132,41.3223140495868
"258","47","6",7,4,5,3,7,6,6,5,4,4,9,8,1,10,5,4,45,46,91,11,15,12.0879120879121,16.4835164835165,50.5494505494505,49.4505494505495
"259","48","1",11,12,13,4,11,19,6,4,12,5,16,6,6,4,4,3,81,58,139,14,35,10.0719424460432,25.1798561151079,41.726618705036,58.273381294964
"260","48","2",7,11,16,4,17,24,4,1,11,9,25,1,4,1,1,2,86,55,141,9,49,6.38297872340426,34.7517730496454,39.0070921985816,60.9929078014184
"261","48","3",1,2,19,0,20,60,0,0,2,17,61,0,0,0,0,0,104,81,185,1,121,0.540540540540541,65.4054054054054,43.7837837837838,56.2162162162162
"262","48","4",9,11,22,0,21,22,0,0,10,11,21,0,0,0,0,0,86,44,130,9,43,6.92307692307692,33.0769230769231,33.8461538461538,66.1538461538462
"263","48","5",0,0,3,3,6,53,6,0,0,6,55,3,0,6,0,0,72,72,144,0,108,0,75,50,50
"264","48","6",7,4,8,0,8,27,0,1,4,4,26,1,0,1,1,1,56,40,96,8,53,8.33333333333333,55.2083333333333,41.6666666666667,58.3333333333333
"265","49","1",1,2,6,2,4,17,6,2,2,6,15,6,3,4,1,2,40,42,82,3,32,3.65853658536585,39.0243902439024,51.219512195122,48.780487804878
"266","49","2",0,0,0,2,0,15,14,6,0,2,15,18,2,19,6,2,38,66,104,2,30,1.92307692307692,28.8461538461538,63.4615384615385,36.5384615384615
"267","49","3",0,0,0,2,2,21,11,3,0,2,24,12,0,14,3,5,41,61,102,5,45,4.90196078431373,44.1176470588235,59.8039215686275,40.1960784313725
"268","49","4",0,1,5,1,2,28,3,2,0,5,25,4,3,2,2,1,43,44,87,1,53,1.14942528735632,60.9195402298851,50.5747126436782,49.4252873563218
"269","49","5",0,0,2,2,2,18,4,1,0,4,19,3,2,3,1,0,31,33,64,0,37,0,57.8125,51.5625,48.4375
"270","49","6",0,0,2,1,1,36,10,0,0,3,35,8,2,8,0,0,51,58,109,0,71,0,65.1376146788991,53.2110091743119,46.7889908256881
"271","5","1",0,0,1,5,5,15,8,4,0,6,20,7,1,11,4,2,40,52,92,2,35,2.17391304347826,38.0434782608696,56.5217391304348,43.4782608695652
"272","5","2",3,4,7,3,8,8,5,4,4,6,10,6,2,7,4,7,44,47,91,10,18,10.989010989011,19.7802197802198,51.6483516483516,48.3516483516484
"273","5","3",0,3,3,2,4,2,2,3,3,2,4,3,1,4,3,6,21,27,48,6,6,12.5,12.5,56.25,43.75
"274","5","4",0,1,2,3,2,2,3,1,1,3,2,2,2,2,1,3,15,18,33,3,4,9.09090909090909,12.1212121212121,54.5454545454545,45.4545454545455
"275","5","5",0,0,0,2,2,2,2,1,0,3,4,1,0,3,1,0,11,13,24,0,6,0,25,54.1666666666667,45.8333333333333
"276","5","6",0,0,1,0,0,8,1,0,0,1,7,1,1,0,0,0,11,12,23,0,15,0,65.2173913043478,52.1739130434783,47.8260869565217
"277","50","1",0,3,4,10,10,23,13,8,3,11,29,10,4,16,8,3,72,86,158,3,52,1.89873417721519,32.9113924050633,54.4303797468354,45.5696202531646
"278","50","2",0,2,8,8,11,67,19,2,2,14,70,12,5,15,2,0,118,122,240,0,137,0,57.0833333333333,50.8333333333333,49.1666666666667
"279","50","3",2,2,4,2,5,69,8,1,2,4,70,7,1,8,1,0,94,95,189,2,139,1.05820105820106,73.5449735449735,50.2645502645503,49.7354497354497
"280","50","4",0,0,8,7,10,69,13,1,0,15,70,7,5,9,1,0,109,109,218,0,139,0,63.7614678899083,50,50
"281","50","5",1,1,15,23,28,90,35,2,1,37,103,14,10,27,2,0,197,195,392,1,193,0.255102040816327,49.234693877551,49.7448979591837,50.2551020408163
"282","50","6",0,0,5,11,8,70,20,3,0,16,73,11,8,15,3,0,118,128,246,0,143,0,58.130081300813,52.0325203252033,47.9674796747967
"283","51","1",1,5,12,1,13,369,9,6,5,8,369,14,1,14,6,1,418,419,837,2,738,0.2389486260454,88.1720430107527,50.0597371565114,49.9402628434886
"284","51","2",0,16,10,13,24,701,8,17,16,7,715,11,0,25,17,2,791,794,1585,2,1416,0.126182965299685,89.3375394321767,50.0946372239748,49.9053627760252
"285","51","3",2,7,5,13,18,787,13,8,7,11,799,8,0,21,8,0,854,856,1710,2,1586,0.116959064327485,92.7485380116959,50.0584795321637,49.9415204678363
"286","51","4",0,6,4,9,13,984,8,10,6,7,992,9,0,18,10,3,1035,1047,2082,3,1976,0.144092219020173,94.9087415946206,50.2881844380403,49.7118155619597
"287","51","5",1,7,8,7,13,1071,6,6,7,8,1076,5,2,10,6,2,1121,1117,2238,3,2147,0.134048257372654,95.9338695263628,49.9106344950849,50.0893655049151
"288","51","6",0,3,6,5,10,392,7,3,3,8,397,5,1,9,3,1,428,428,856,1,789,0.116822429906542,92.1728971962617,50,50
"289","52","1",1,2,5,5,6,14,4,6,2,8,14,5,4,6,6,7,44,54,98,8,28,8.16326530612245,28.5714285714286,55.1020408163265,44.8979591836735
"290","52","2",6,5,3,6,4,18,12,6,5,4,20,12,5,13,6,5,62,71,133,11,38,8.27067669172932,28.5714285714286,53.3834586466165,46.6165413533835
"291","52","3",0,0,2,3,5,21,7,2,0,5,24,6,0,9,2,0,41,48,89,0,45,0,50.561797752809,53.9325842696629,46.0674157303371
"292","52","4",0,1,3,0,3,31,6,1,1,2,30,7,0,7,1,0,46,50,96,0,61,0,63.5416666666667,52.0833333333333,47.9166666666667
"293","52","5",0,0,2,1,1,36,6,1,0,3,35,6,2,5,1,0,49,53,102,0,71,0,69.6078431372549,51.9607843137255,48.0392156862745
"294","52","6",0,0,0,0,0,63,2,0,0,0,63,2,0,2,0,0,66,69,135,0,126,0,93.3333333333333,51.1111111111111,48.8888888888889
"295","53","1",0,0,6,1,6,25,3,1,0,8,24,3,2,2,1,0,44,41,85,0,49,0,57.6470588235294,48.2352941176471,51.7647058823529
"296","53","2",6,3,15,3,13,29,10,2,3,15,28,9,5,7,2,6,83,76,159,12,57,7.54716981132075,35.8490566037736,47.7987421383648,52.2012578616352
"297","53","3",6,9,27,0,28,29,0,0,9,18,29,0,0,0,0,0,101,57,158,6,58,3.79746835443038,36.7088607594937,36.0759493670886,63.9240506329114
"298","53","4",4,15,41,0,40,13,0,1,15,26,11,1,1,0,1,0,115,57,172,4,24,2.32558139534884,13.953488372093,33.1395348837209,66.8604651162791
"299","53","5",0,2,20,1,20,54,2,0,2,18,55,1,0,2,0,0,101,79,180,0,109,0,60.5555555555556,43.8888888888889,56.1111111111111
"300","53","6",16,7,16,3,15,33,4,1,7,13,32,2,4,1,1,4,97,65,162,20,65,12.3456790123457,40.1234567901235,40.1234567901235,59.8765432098765
"301","54","1",0,1,10,2,8,19,6,3,1,11,18,7,4,5,3,2,51,52,103,2,37,1.94174757281553,35.9223300970874,50.4854368932039,49.5145631067961
"302","54","2",1,3,9,2,10,21,5,0,4,8,22,3,2,4,1,0,54,44,98,1,43,1.02040816326531,43.8775510204082,44.8979591836735,55.1020408163265
"303","54","3",6,4,14,0,13,19,0,0,4,10,18,0,1,0,1,0,57,36,93,6,37,6.45161290322581,39.7849462365591,38.7096774193548,61.2903225806452
"304","54","4",0,0,7,1,7,17,2,0,0,8,16,2,1,1,0,0,35,30,65,0,33,0,50.7692307692308,46.1538461538462,53.8461538461538
"305","54","5",0,0,2,1,2,12,3,1,0,3,11,3,2,2,1,0,23,23,46,0,23,0,50,50,50
"306","54","6",1,1,3,4,4,33,5,3,1,7,34,4,3,5,3,4,56,62,118,5,67,4.23728813559322,56.7796610169492,52.5423728813559,47.4576271186441
"307","55","1",4,4,5,1,6,25,2,0,4,3,26,1,0,2,0,0,49,37,86,4,51,4.65116279069767,59.3023255813954,43.0232558139535,56.9767441860465
"308","55","2",0,0,5,1,5,18,2,2,0,6,18,3,1,3,2,1,35,35,70,1,36,1.42857142857143,51.4285714285714,50,50
"309","55","3",0,1,5,2,3,7,5,0,1,6,5,3,4,1,0,0,25,21,46,0,12,0,26.0869565217391,45.6521739130435,54.3478260869565
"310","55","4",0,0,0,0,0,7,1,0,0,0,6,1,0,1,0,0,9,10,19,0,13,0,68.4210526315789,52.6315789473684,47.3684210526316
"311","55","5",0,0,0,1,1,2,1,0,0,1,3,0,0,2,1,0,6,9,15,0,5,0,33.3333333333333,60,40
"312","55","6",0,0,1,0,0,6,2,0,0,1,4,2,2,0,0,0,11,10,21,0,10,0,47.6190476190476,47.6190476190476,52.3809523809524
"313","56","1",2,1,7,3,8,22,5,2,1,9,23,4,2,5,2,2,52,49,101,4,45,3.96039603960396,44.5544554455446,48.5148514851485,51.4851485148515
"314","56","2",0,1,6,4,7,27,6,1,1,9,29,3,3,5,2,9,54,62,116,9,56,7.75862068965517,48.2758620689655,53.448275862069,46.551724137931
"315","56","3",0,0,5,1,5,37,6,0,0,6,38,5,1,5,0,0,56,56,112,0,75,0,66.9642857142857,50,50
"316","56","4",1,1,2,1,2,54,4,0,1,2,54,3,1,3,0,0,67,65,132,1,108,0.757575757575758,81.8181818181818,49.2424242424242,50.7575757575758
"317","56","5",1,1,1,0,1,88,0,0,1,0,89,0,0,0,0,0,94,91,185,1,177,0.540540540540541,95.6756756756757,49.1891891891892,50.8108108108108
"318","56","6",0,0,0,0,0,124,0,0,0,0,124,0,0,0,0,0,125,126,251,0,248,0,98.804780876494,50.199203187251,49.800796812749
"319","57","1",0,2,4,4,2,21,12,6,2,5,19,14,6,12,6,3,53,68,121,3,40,2.47933884297521,33.0578512396694,56.198347107438,43.801652892562
"320","57","2",0,1,2,1,1,20,19,9,1,2,20,27,1,27,9,9,55,97,152,9,40,5.92105263157895,26.3157894736842,63.8157894736842,36.1842105263158
"321","57","3",0,0,0,1,1,73,1,2,0,1,74,2,0,3,2,2,79,86,165,2,147,1.21212121212121,89.0909090909091,52.1212121212121,47.8787878787879
"322","57","4",0,1,4,1,5,60,4,0,1,4,61,3,0,4,0,0,77,74,151,0,121,0,80.1324503311258,49.0066225165563,50.9933774834437
"323","57","5",0,0,5,7,11,51,12,0,0,12,58,5,1,11,0,0,88,88,176,0,109,0,61.9318181818182,50,50
"324","57","6",0,0,2,3,5,20,5,1,0,5,23,3,0,6,1,1,37,41,78,1,43,1.28205128205128,55.1282051282051,52.5641025641026,47.4358974358974
"325","58","1",4,3,4,4,5,41,7,4,3,5,42,7,4,7,4,12,74,85,159,16,83,10.062893081761,52.2012578616352,53.4591194968553,46.5408805031447
"326","58","2",0,0,1,3,3,54,7,1,0,4,55,5,1,6,0,0,69,74,143,0,109,0,76.2237762237762,51.7482517482517,48.2517482517483
"327","58","3",0,0,0,1,1,47,13,1,0,1,47,13,0,14,1,0,64,78,142,0,94,0,66.1971830985916,54.9295774647887,45.0704225352113
"328","58","4",0,0,0,0,0,44,14,1,0,0,44,16,0,15,1,0,60,78,138,0,88,0,63.768115942029,56.5217391304348,43.4782608695652
"329","58","5",0,0,0,1,0,27,10,3,0,1,27,12,1,12,3,0,43,57,100,0,54,0,54,57,43
"330","58","6",5,2,4,1,3,20,1,3,2,3,19,3,2,1,2,12,39,47,86,17,39,19.7674418604651,45.3488372093023,54.6511627906977,45.3488372093023
"331","59","1",5,5,7,8,6,16,11,2,5,10,15,5,9,5,3,0,61,54,115,5,31,4.34782608695652,26.9565217391304,46.9565217391304,53.0434782608696
"332","59","2",0,1,2,3,1,17,12,3,1,4,16,11,4,11,3,2,40,54,94,2,33,2.12765957446809,35.1063829787234,57.4468085106383,42.5531914893617
"333","59","3",1,1,1,1,2,19,3,2,1,1,20,4,0,5,2,1,32,35,67,2,39,2.98507462686567,58.2089552238806,52.2388059701493,47.7611940298507
"334","59","4",0,0,0,0,0,29,0,0,0,0,30,0,0,0,0,0,31,31,62,0,59,0,95.1612903225806,50,50
"335","59","5",0,0,0,1,0,15,3,0,0,1,16,2,1,2,0,0,21,23,44,0,31,0,70.4545454545455,52.2727272727273,47.7272727272727
"336","59","6",0,2,5,7,9,49,12,2,2,11,53,7,4,10,2,0,88,90,178,0,102,0,57.3033707865169,50.561797752809,49.438202247191
"337","6","1",5,11,35,2,33,213,15,7,11,26,211,20,4,18,7,0,323,298,621,5,424,0.805152979066023,68.2769726247987,47.9871175523349,52.0128824476651
"338","6","2",0,17,44,4,44,363,20,2,17,31,363,18,4,18,2,0,496,454,950,0,726,0,76.4210526315789,47.7894736842105,52.2105263157895
"339","6","3",0,6,36,6,34,418,27,13,6,35,416,34,7,32,13,0,541,545,1086,0,834,0,76.7955801104972,50.1841620626151,49.8158379373849
"340","6","4",0,7,27,9,24,215,18,9,7,29,212,18,12,15,9,0,311,303,614,0,427,0,69.5439739413681,49.3485342019544,50.6514657980456
"341","6","5",3,8,39,3,31,260,17,7,8,34,253,21,10,14,7,2,370,350,720,5,513,0.694444444444444,71.25,48.6111111111111,51.3888888888889
"342","6","6",0,8,38,3,35,586,28,7,8,32,583,32,5,30,7,2,706,701,1407,2,1169,0.142146410803127,83.0845771144279,49.8223169864961,50.1776830135039
"343","60","1",1,4,10,2,7,39,10,7,4,8,36,15,5,12,7,7,82,95,177,8,75,4.51977401129944,42.3728813559322,53.6723163841808,46.3276836158192
"344","60","2",0,0,2,3,3,58,9,3,0,5,59,9,2,10,3,0,80,89,169,0,117,0,69.2307692307692,52.6627218934911,47.3372781065089
"345","60","3",0,1,4,2,5,40,6,1,1,6,41,5,2,5,1,0,61,62,123,0,81,0,65.8536585365854,50.4065040650407,49.5934959349593
"346","60","4",0,0,1,1,1,37,12,2,0,2,37,13,0,14,2,0,55,70,125,0,74,0,59.2,56,44
"347","60","5",0,0,0,1,0,32,15,7,0,1,33,20,1,21,7,8,57,92,149,8,65,5.36912751677852,43.6241610738255,61.744966442953,38.255033557047
"348","60","6",2,4,3,4,5,26,7,9,4,3,28,13,2,14,9,12,61,87,148,14,54,9.45945945945946,36.4864864864865,58.7837837837838,41.2162162162162
"349","61","1",0,4,3,4,4,16,17,5,4,3,17,19,3,20,5,5,54,78,132,5,33,3.78787878787879,25,59.0909090909091,40.9090909090909
"350","61","2",0,1,1,2,2,15,14,8,1,2,17,20,1,22,9,4,45,77,122,4,32,3.27868852459016,26.2295081967213,63.1147540983607,36.8852459016393
"351","61","3",0,0,0,1,0,13,2,3,0,1,13,4,1,3,3,3,20,30,50,3,26,6,52,60,40
"352","61","4",0,0,1,0,1,34,3,1,0,1,35,3,0,4,1,0,42,45,87,0,69,0,79.3103448275862,51.7241379310345,48.2758620689655
"353","61","5",0,0,2,0,2,59,2,1,0,2,59,3,0,4,1,3,67,74,141,3,118,2.12765957446809,83.6879432624114,52.4822695035461,47.5177304964539
"354","61","6",0,0,8,1,9,19,2,1,0,9,20,2,0,3,1,1,42,37,79,1,39,1.26582278481013,49.3670886075949,46.8354430379747,53.1645569620253
"355","62","1",3,5,11,5,11,16,4,5,5,11,16,4,5,4,5,4,62,55,117,7,32,5.98290598290598,27.3504273504273,47.008547008547,52.991452991453
"356","62","2",1,2,15,1,16,28,2,0,2,14,29,1,0,2,0,0,66,50,116,1,57,0.862068965517241,49.1379310344828,43.1034482758621,56.8965517241379
"357","62","3",1,6,23,1,24,16,2,0,7,18,16,1,1,1,0,0,76,44,120,1,32,0.833333333333333,26.6666666666667,36.6666666666667,63.3333333333333
"358","62","4",3,2,7,0,5,30,2,0,2,4,28,2,1,1,0,0,50,40,90,3,58,3.33333333333333,64.4444444444444,44.4444444444444,55.5555555555556
"359","62","5",0,1,2,0,2,76,0,0,1,1,75,0,0,0,0,0,82,79,161,0,151,0,93.7888198757764,49.0683229813665,50.9316770186335
"360","62","6",1,1,0,1,0,59,1,1,1,0,58,1,1,0,1,0,65,64,129,1,117,0.775193798449612,90.6976744186046,49.6124031007752,50.3875968992248
"361","63","1",5,6,6,6,5,13,10,6,6,6,12,10,7,8,5,12,57,69,126,17,25,13.4920634920635,19.8412698412698,54.7619047619048,45.2380952380952
"362","63","2",0,2,1,5,3,0,1,9,3,4,1,5,4,6,9,13,24,45,69,13,1,18.8405797101449,1.44927536231884,65.2173913043478,34.7826086956522
"363","63","3",0,0,0,0,0,8,1,3,0,0,8,4,0,4,3,11,12,33,45,11,16,24.4444444444444,35.5555555555556,73.3333333333333,26.6666666666667
"364","63","4",1,1,2,1,1,8,3,0,1,2,6,2,3,0,0,0,19,15,34,1,14,2.94117647058824,41.1764705882353,44.1176470588235,55.8823529411765
"365","63","5",1,2,0,1,1,1,2,3,2,0,2,4,1,5,4,1,13,20,33,2,3,6.06060606060606,9.09090909090909,60.6060606060606,39.3939393939394
"366","63","6",1,1,3,2,2,23,4,5,1,4,22,7,3,7,5,6,42,57,99,7,45,7.07070707070707,45.4545454545455,57.5757575757576,42.4242424242424
"367","64","1",14,8,18,5,18,19,8,1,8,16,19,4,6,4,2,3,93,63,156,17,38,10.8974358974359,24.3589743589744,40.3846153846154,59.6153846153846
"368","64","2",0,0,7,7,8,32,14,3,0,13,33,10,5,12,3,1,72,79,151,1,65,0.662251655629139,43.046357615894,52.317880794702,47.682119205298
"369","64","3",2,1,6,0,5,53,4,1,1,5,52,5,1,3,1,1,73,71,144,3,105,2.08333333333333,72.9166666666667,49.3055555555556,50.6944444444444
"370","64","4",2,3,9,2,11,57,13,0,3,9,59,10,1,12,0,0,99,95,194,2,116,1.03092783505155,59.7938144329897,48.9690721649485,51.0309278350515
"371","64","5",0,1,6,6,7,39,15,1,1,11,39,10,5,11,1,0,76,80,156,0,78,0,50,51.2820512820513,48.7179487179487
"372","64","6",5,8,8,4,8,37,13,1,8,4,37,9,4,10,1,0,85,75,160,5,74,3.125,46.25,46.875,53.125
"373","65","1",0,2,6,0,5,24,2,3,2,4,24,5,1,4,3,0,44,44,88,0,48,0,54.5454545454545,50,50
"374","65","2",0,0,4,1,5,44,3,1,0,5,44,3,0,4,1,2,59,61,120,2,88,1.66666666666667,73.3333333333333,50.8333333333333,49.1666666666667
"375","65","3",0,1,2,2,3,13,6,0,1,3,14,3,1,4,0,0,28,28,56,0,27,0,48.2142857142857,50,50
"376","65","4",0,0,0,0,1,1,1,0,0,1,1,1,0,1,0,0,5,5,10,0,2,0,20,50,50
"377","65","5",0,0,0,1,1,5,2,0,0,1,7,0,0,2,0,0,11,11,22,0,12,0,54.5454545454545,50,50
"378","65","6",0,1,0,3,1,2,3,1,1,2,3,0,3,1,1,0,13,12,25,0,5,0,20,48,52
"379","66","1",1,2,3,3,4,11,6,6,2,4,12,10,1,11,6,8,37,56,93,9,23,9.67741935483871,24.7311827956989,60.2150537634409,39.7849462365591
"380","66","2",1,2,1,4,3,15,20,3,2,3,17,19,2,20,3,1,50,69,119,2,32,1.68067226890756,26.890756302521,57.9831932773109,42.0168067226891
"381","66","3",0,0,6,4,5,26,12,0,0,10,25,8,5,7,0,0,54,57,111,0,51,0,45.9459459459459,51.3513513513514,48.6486486486486
"382","66","4",0,0,3,3,3,25,7,0,0,6,25,3,3,3,0,0,42,42,84,0,50,0,59.5238095238095,50,50
"383","66","5",0,0,2,0,1,25,3,0,0,2,24,3,1,2,0,0,33,33,66,0,49,0,74.2424242424242,50,50
"384","66","6",0,0,2,0,1,19,2,0,0,2,18,2,1,1,0,0,26,25,51,0,37,0,72.5490196078431,49.0196078431373,50.9803921568627
"385","67","1",11,4,11,3,10,8,5,1,4,10,6,3,5,1,1,1,55,32,87,12,14,13.7931034482759,16.0919540229885,36.7816091954023,63.2183908045977
"386","67","2",6,9,20,0,18,19,0,2,8,11,18,2,1,1,2,1,76,45,121,7,37,5.78512396694215,30.5785123966942,37.1900826446281,62.8099173553719
"387","67","3",1,3,15,0,15,38,2,1,3,13,38,2,1,2,1,0,77,61,138,1,76,0.72463768115942,55.0724637681159,44.2028985507246,55.7971014492754
"388","67","4",1,2,10,0,8,32,2,1,2,7,30,3,1,2,1,0,57,48,105,1,62,0.952380952380952,59.0476190476191,45.7142857142857,54.2857142857143
"389","67","5",0,0,6,0,6,30,3,3,0,6,30,7,0,6,3,1,49,55,104,1,60,0.961538461538462,57.6923076923077,52.8846153846154,47.1153846153846
"390","67","6",0,0,5,1,4,31,10,1,0,6,31,10,2,9,1,0,54,60,114,0,62,0,54.3859649122807,52.6315789473684,47.3684210526316
"391","68","1",0,4,10,4,8,20,14,2,4,9,18,13,5,11,2,0,63,64,127,0,38,0,29.9212598425197,50.3937007874016,49.6062992125984
"392","68","2",0,0,2,2,3,35,10,3,0,4,37,10,1,12,3,0,57,68,125,0,72,0,57.6,54.4,45.6
"393","68","3",0,0,3,0,3,72,3,0,0,3,73,3,0,3,0,0,83,83,166,0,145,0,87.3493975903614,50,50
"394","68","4",0,0,1,0,1,107,0,0,0,1,108,0,0,0,0,0,111,110,221,0,215,0,97.2850678733032,49.7737556561086,50.2262443438914
"395","68","5",0,0,0,0,0,121,0,0,0,0,121,0,0,0,0,0,122,123,245,0,242,0,98.7755102040816,50.2040816326531,49.7959183673469
"396","68","6",0,0,1,0,0,114,1,0,0,1,112,1,1,0,0,0,117,117,234,0,226,0,96.5811965811966,50,50
"397","69","1",3,2,12,4,11,15,8,4,2,14,14,8,5,7,4,2,61,57,118,5,29,4.23728813559322,24.5762711864407,48.3050847457627,51.6949152542373
"398","69","2",0,0,8,1,5,45,4,1,0,9,43,4,4,1,1,1,66,64,130,1,88,0.769230769230769,67.6923076923077,49.2307692307692,50.7692307692308
"399","69","3",0,4,13,1,12,37,1,2,4,10,36,2,1,2,2,0,71,59,130,0,73,0,56.1538461538462,45.3846153846154,54.6153846153846
"400","69","4",0,2,20,3,22,24,3,1,2,21,26,1,1,3,1,1,77,57,134,1,50,0.746268656716418,37.3134328358209,42.5373134328358,57.4626865671642
"401","69","5",0,2,12,1,12,24,1,1,2,11,24,1,1,1,1,0,55,42,97,0,48,0,49.4845360824742,43.298969072165,56.701030927835
"402","69","6",0,2,8,0,8,27,1,0,2,6,26,1,0,1,0,0,47,38,85,0,53,0,62.3529411764706,44.7058823529412,55.2941176470588
"403","7","1",4,3,4,6,9,41,13,3,3,7,45,10,1,15,3,1,84,87,171,5,86,2.92397660818713,50.2923976608187,50.8771929824561,49.1228070175439
"404","7","2",0,0,1,1,0,46,16,7,0,1,45,22,1,22,7,0,72,100,172,0,91,0,52.906976744186,58.1395348837209,41.8604651162791
"405","7","3",0,0,3,3,4,62,8,0,0,6,63,5,2,7,0,0,81,85,166,0,125,0,75.3012048192771,51.2048192771084,48.7951807228916
"406","7","4",0,1,5,1,3,30,5,0,1,5,29,3,3,2,0,0,47,44,91,0,59,0,64.8351648351648,48.3516483516484,51.6483516483516
"407","7","5",1,1,5,2,3,32,6,1,1,6,31,5,3,4,1,1,53,53,106,2,63,1.88679245283019,59.4339622641509,50,50
"408","7","6",0,0,2,0,2,37,7,1,1,2,37,8,1,7,1,1,52,58,110,1,74,0.909090909090909,67.2727272727273,52.7272727272727,47.2727272727273
"409","70","1",0,2,3,5,5,20,7,4,2,6,22,6,3,7,4,5,47,57,104,5,42,4.80769230769231,40.3846153846154,54.8076923076923,45.1923076923077
"410","70","2",0,0,5,10,8,38,19,2,0,14,41,11,6,15,2,3,83,94,177,3,79,1.69491525423729,44.6327683615819,53.1073446327684,46.8926553672316
"411","70","3",0,0,0,4,1,39,19,2,0,5,40,16,4,17,2,4,67,89,156,4,79,2.56410256410256,50.6410256410256,57.0512820512821,42.9487179487179
"412","70","4",0,0,2,3,1,82,5,0,0,5,80,2,4,1,0,0,94,94,188,0,162,0,86.1702127659574,50,50
"413","70","5",0,0,0,2,2,63,0,2,0,2,65,0,0,2,2,8,71,80,151,8,128,5.29801324503311,84.7682119205298,52.9801324503311,47.0198675496689
"414","70","6",0,0,3,0,1,40,3,0,0,3,39,2,2,1,0,0,49,48,97,0,79,0,81.4432989690722,49.4845360824742,50.5154639175258
"415","71","1",10,6,8,4,6,5,5,6,7,5,3,7,6,5,6,3,53,42,95,13,8,13.6842105263158,8.42105263157895,44.2105263157895,55.7894736842105
"416","71","2",2,5,2,8,4,4,6,5,5,5,6,3,5,5,5,2,37,38,75,4,10,5.33333333333333,13.3333333333333,50.6666666666667,49.3333333333333
"417","71","3",0,3,5,1,4,10,4,1,3,3,9,4,2,3,1,3,30,29,59,3,19,5.08474576271186,32.2033898305085,49.1525423728814,50.8474576271186
"418","71","4",3,3,4,2,2,12,5,2,3,3,11,5,4,4,3,1,35,35,70,4,23,5.71428571428571,32.8571428571429,50,50
"419","71","5",1,3,4,1,4,15,4,2,3,2,14,5,1,4,2,2,35,35,70,3,29,4.28571428571429,41.4285714285714,50,50
"420","71","6",0,1,0,2,1,13,4,4,1,1,14,6,1,8,4,8,26,45,71,8,27,11.2676056338028,38.0281690140845,63.3802816901408,36.6197183098592
"421","72","1",0,0,9,1,6,26,6,2,0,10,24,7,4,4,2,5,52,57,109,5,50,4.58715596330275,45.8715596330275,52.2935779816514,47.7064220183486
"422","72","2",2,2,14,0,13,30,1,0,2,12,30,1,0,1,0,0,64,47,111,2,60,1.8018018018018,54.0540540540541,42.3423423423423,57.6576576576577
"423","72","3",1,3,8,2,6,33,7,0,3,8,31,5,5,2,0,0,62,55,117,1,64,0.854700854700855,54.7008547008547,47.008547008547,52.991452991453
"424","72","4",0,0,3,0,3,44,3,0,0,3,43,3,0,3,0,0,54,54,108,0,87,0,80.5555555555556,50,50
"425","72","5",0,0,2,0,2,52,2,0,0,2,52,2,0,2,0,0,60,59,119,0,104,0,87.3949579831933,49.5798319327731,50.4201680672269
"426","72","6",0,0,4,1,2,18,3,1,0,5,16,3,2,2,1,0,30,31,61,0,34,0,55.7377049180328,50.8196721311475,49.1803278688525
"427","73","1",1,2,9,4,9,26,7,3,2,11,26,6,4,7,3,2,62,63,125,3,52,2.4,41.6,50.4,49.6
"428","73","2",0,0,2,1,2,30,5,4,0,3,30,8,2,8,5,4,46,61,107,4,60,3.73831775700935,56.0747663551402,57.0093457943925,42.9906542056075
"429","73","3",18,9,10,1,11,7,1,0,10,2,7,0,1,0,0,0,60,20,80,18,14,22.5,17.5,25,75
"430","73","4",1,2,3,1,4,9,3,2,2,2,9,4,0,4,2,2,26,27,53,3,18,5.66037735849057,33.9622641509434,50.9433962264151,49.0566037735849
"431","73","5",8,6,6,2,8,13,2,0,6,3,15,0,1,1,0,0,47,27,74,8,28,10.8108108108108,37.8378378378378,36.4864864864865,63.5135135135135
"432","73","6",4,2,3,0,3,9,0,0,2,1,8,0,0,0,0,0,22,13,35,4,17,11.4285714285714,48.5714285714286,37.1428571428571,62.8571428571429
"433","74","1",6,6,5,8,5,18,14,4,6,7,18,11,7,11,4,3,67,69,136,9,36,6.61764705882353,26.4705882352941,50.7352941176471,49.2647058823529
"434","74","2",4,3,1,4,2,9,8,4,3,3,10,7,4,8,4,5,37,45,82,9,19,10.9756097560976,23.1707317073171,54.8780487804878,45.1219512195122
"435","74","3",0,1,2,1,1,3,4,2,1,2,2,5,2,3,1,11,14,30,44,11,5,25,11.3636363636364,68.1818181818182,31.8181818181818
"436","74","4",0,0,0,2,1,2,2,4,0,2,3,4,1,5,4,5,11,27,38,5,5,13.1578947368421,13.1578947368421,71.0526315789474,28.9473684210526
"437","74","5",0,0,0,2,1,0,4,2,0,2,1,3,1,4,1,2,9,17,26,2,1,7.69230769230769,3.84615384615385,65.3846153846154,34.6153846153846
"438","74","6",0,0,2,0,1,4,0,1,0,2,4,1,1,1,1,4,10,15,25,4,8,16,32,60,40
"439","75","1",0,3,6,4,7,25,15,11,3,7,26,22,3,24,11,16,72,114,186,16,51,8.60215053763441,27.4193548387097,61.2903225806452,38.7096774193548
"440","75","2",0,0,2,2,2,13,13,20,0,4,13,32,2,31,20,25,53,129,182,25,26,13.7362637362637,14.2857142857143,70.8791208791209,29.1208791208791
"441","75","3",0,0,0,0,0,7,12,18,0,0,7,30,0,30,18,38,37,126,163,38,14,23.3128834355828,8.58895705521472,77.3006134969325,22.6993865030675
"442","75","4",0,0,0,0,0,14,20,12,0,0,14,32,0,32,12,10,47,102,149,10,28,6.71140939597315,18.7919463087248,68.4563758389262,31.5436241610738
"443","75","5",0,0,0,0,0,17,22,14,0,0,17,35,0,36,14,14,54,118,172,14,34,8.13953488372093,19.7674418604651,68.6046511627907,31.3953488372093
"444","75","6",0,0,1,1,1,31,17,8,0,3,31,24,2,23,8,7,61,99,160,7,62,4.375,38.75,61.875,38.125
"445","76","1",8,4,8,7,7,25,11,7,4,10,24,11,7,10,6,3,77,78,155,11,49,7.09677419354839,31.6129032258065,50.3225806451613,49.6774193548387
"446","76","2",0,2,4,2,6,27,11,2,2,4,28,11,0,12,2,1,55,62,117,1,55,0.854700854700855,47.008547008547,52.991452991453,47.008547008547
"447","76","3",0,0,0,2,2,35,9,1,0,2,37,8,0,10,1,0,50,60,110,0,72,0,65.4545454545455,54.5454545454545,45.4545454545455
"448","76","4",2,1,2,2,4,58,3,0,1,3,59,1,0,3,0,0,73,69,142,2,117,1.40845070422535,82.3943661971831,48.5915492957746,51.4084507042254
"449","76","5",1,2,1,1,1,33,4,1,2,0,33,4,1,4,1,1,46,47,93,2,66,2.1505376344086,70.9677419354839,50.5376344086022,49.4623655913978
"450","76","6",1,2,5,3,6,18,2,3,2,6,19,2,2,2,2,3,40,41,81,4,37,4.93827160493827,45.679012345679,50.6172839506173,49.3827160493827
"451","77","1",11,7,11,5,10,20,3,8,7,10,19,6,7,5,9,5,77,69,146,16,39,10.958904109589,26.7123287671233,47.2602739726027,52.7397260273973
"452","77","2",3,3,6,6,4,21,11,1,3,9,20,6,7,5,1,0,57,52,109,3,41,2.75229357798165,37.6146788990826,47.7064220183486,52.2935779816514
"453","77","3",0,2,5,1,6,32,1,1,2,4,34,1,0,2,1,0,50,45,95,0,66,0,69.4736842105263,47.3684210526316,52.6315789473684
"454","77","4",2,4,2,3,3,16,4,0,4,1,17,0,2,1,0,0,35,27,62,2,33,3.2258064516129,53.2258064516129,43.5483870967742,56.4516129032258
"455","77","5",0,0,1,1,1,39,4,0,0,2,38,3,1,3,0,0,47,49,96,0,77,0,80.2083333333333,51.0416666666667,48.9583333333333
"456","77","6",1,1,3,0,2,9,1,0,1,2,8,1,1,0,0,0,19,14,33,1,17,3.03030303030303,51.5151515151515,42.4242424242424,57.5757575757576
"457","78","1",5,5,4,4,3,24,8,7,5,3,22,12,5,10,7,7,61,73,134,12,46,8.95522388059701,34.3283582089552,54.4776119402985,45.5223880597015
"458","78","2",2,1,12,7,15,23,13,2,1,18,27,8,3,12,2,3,77,75,152,5,50,3.28947368421053,32.8947368421053,49.3421052631579,50.6578947368421
"459","78","3",0,0,4,2,6,76,9,0,0,6,77,7,0,8,0,0,98,100,198,0,153,0,77.2727272727273,50.5050505050505,49.4949494949495
"460","78","4",0,0,4,1,4,113,2,1,0,5,113,2,1,2,1,0,126,126,252,0,226,0,89.6825396825397,50,50
"461","78","5",0,0,1,0,1,101,1,0,0,1,101,1,0,1,0,0,106,105,211,0,202,0,95.7345971563981,49.7630331753555,50.2369668246445
"462","78","6",7,6,4,5,6,61,5,4,6,4,63,4,4,5,4,4,100,95,195,11,124,5.64102564102564,63.5897435897436,48.7179487179487,51.2820512820513
"463","79","1",3,8,16,4,15,9,2,3,8,11,8,1,4,1,3,1,61,39,100,4,17,4,17,39,61
"464","79","2",0,0,6,1,5,17,5,0,0,7,16,4,2,3,0,0,36,33,69,0,33,0,47.8260869565217,47.8260869565217,52.1739130434783
"465","79","3",0,0,3,0,2,35,1,0,0,2,34,1,0,1,0,0,42,40,82,0,69,0,84.1463414634146,48.780487804878,51.219512195122
"466","79","4",2,1,3,0,2,15,3,0,1,2,14,2,1,2,0,0,27,24,51,2,29,3.92156862745098,56.8627450980392,47.0588235294118,52.9411764705882
"467","79","5",0,0,1,0,1,11,3,1,0,1,10,4,0,3,1,0,18,21,39,0,21,0,53.8461538461538,53.8461538461538,46.1538461538462
"468","79","6",0,1,7,1,6,12,4,1,1,7,11,4,2,3,1,1,34,31,65,1,23,1.53846153846154,35.3846153846154,47.6923076923077,52.3076923076923
"469","8","1",6,6,8,3,6,15,4,9,6,4,14,10,4,9,9,21,59,78,137,27,29,19.7080291970803,21.1678832116788,56.9343065693431,43.0656934306569
"470","8","2",2,3,10,3,8,14,4,6,3,10,12,7,4,5,6,11,51,60,111,13,26,11.7117117117117,23.4234234234234,54.0540540540541,45.9459459459459
"471","8","3",8,1,3,2,2,6,3,1,2,4,5,2,3,1,1,2,29,20,49,10,11,20.4081632653061,22.4489795918367,40.8163265306122,59.1836734693878
"472","8","4",0,1,0,1,1,6,1,1,1,0,6,1,0,1,1,3,12,15,27,3,12,11.1111111111111,44.4444444444444,55.5555555555556,44.4444444444444
"473","8","5",1,1,4,1,4,10,4,0,2,4,10,2,2,2,0,0,28,22,50,1,20,2,40,44,56
"474","8","6",1,1,4,2,2,23,4,0,1,5,22,2,3,1,0,0,39,35,74,1,45,1.35135135135135,60.8108108108108,47.2972972972973,52.7027027027027
"475","80","1",10,11,18,4,17,11,8,3,10,11,10,7,4,6,3,2,83,55,138,12,21,8.69565217391304,15.2173913043478,39.8550724637681,60.1449275362319
"476","80","2",2,3,5,7,6,7,12,2,3,9,9,7,5,9,2,0,46,45,91,2,16,2.1978021978022,17.5824175824176,49.4505494505495,50.5494505494505
"477","80","3",1,1,3,0,3,18,4,0,1,2,18,5,0,4,0,0,31,32,63,1,36,1.58730158730159,57.1428571428571,50.7936507936508,49.2063492063492
"478","80","4",0,0,3,0,2,17,2,0,0,3,15,2,1,1,0,0,25,24,49,0,32,0,65.3061224489796,48.9795918367347,51.0204081632653
"479","80","5",0,0,1,1,1,15,2,1,0,2,15,1,1,2,1,0,22,24,46,0,30,0,65.2173913043478,52.1739130434783,47.8260869565217
"480","80","6",3,1,2,2,3,6,1,2,1,3,6,1,1,1,2,1,21,18,39,4,12,10.2564102564103,30.7692307692308,46.1538461538462,53.8461538461538
"481","81","1",7,7,10,7,7,26,10,5,7,10,23,7,10,5,5,11,80,80,160,18,49,11.25,30.625,50,50
"482","81","2",1,4,15,3,14,47,6,1,4,14,46,4,4,3,1,0,93,77,170,1,93,0.588235294117647,54.7058823529412,45.2941176470588,54.7058823529412
"483","81","3",10,4,24,0,24,39,0,0,4,20,38,0,0,0,0,0,102,64,166,10,77,6.02409638554217,46.3855421686747,38.5542168674699,61.4457831325301
"484","81","4",0,5,13,5,12,30,10,2,5,13,29,7,6,6,2,3,79,72,151,3,59,1.98675496688742,39.0728476821192,47.682119205298,52.317880794702
"485","81","5",0,0,9,2,8,25,9,4,0,11,25,11,3,10,4,5,59,70,129,5,50,3.87596899224806,38.7596899224806,54.2635658914729,45.7364341085271
"486","81","6",3,1,6,2,6,16,5,3,2,6,16,6,2,6,3,3,45,44,89,6,32,6.74157303370786,35.9550561797753,49.438202247191,50.561797752809
"487","82","1",1,3,7,4,7,18,8,2,3,8,19,6,4,6,2,4,52,53,105,5,37,4.76190476190476,35.2380952380952,50.4761904761905,49.5238095238095
"488","82","2",0,0,6,1,6,32,2,2,0,7,31,3,1,3,2,1,50,50,100,1,63,1,63,50,50
"489","82","3",0,0,0,2,2,1,3,0,0,2,2,1,0,2,0,0,9,9,18,0,3,0,16.6666666666667,50,50
"490","82","4",0,0,0,0,0,19,4,2,0,1,19,6,1,5,2,1,27,36,63,1,38,1.58730158730159,60.3174603174603,57.1428571428571,42.8571428571429
"491","82","5",2,1,1,0,1,1,1,1,1,0,1,2,0,1,1,1,9,9,18,3,2,16.6666666666667,11.1111111111111,50,50
"492","82","6",0,0,2,1,2,15,1,1,0,3,15,1,1,1,1,0,23,24,47,0,30,0,63.8297872340426,51.063829787234,48.936170212766
"493","83","1",6,5,15,4,12,24,5,5,5,14,20,6,7,3,5,5,77,67,144,11,44,7.63888888888889,30.5555555555556,46.5277777777778,53.4722222222222
"494","83","2",0,2,9,3,5,36,10,4,2,10,32,11,7,7,4,1,71,75,146,1,68,0.684931506849315,46.5753424657534,51.3698630136986,48.6301369863014
"495","83","3",0,2,7,1,8,25,5,1,2,6,27,5,0,6,1,0,51,48,99,0,52,0,52.5252525252525,48.4848484848485,51.5151515151515
"496","83","4",0,1,2,0,1,11,1,3,1,1,11,4,1,3,3,0,21,25,46,0,22,0,47.8260869565217,54.3478260869565,45.6521739130435
"497","83","5",0,4,9,0,9,24,0,0,4,5,24,0,0,0,0,0,48,34,82,0,48,0,58.5365853658537,41.4634146341463,58.5365853658537
"498","83","6",0,0,6,0,6,22,1,0,0,6,22,1,0,1,0,0,37,31,68,0,44,0,64.7058823529412,45.5882352941176,54.4117647058824
"499","84","1",9,4,19,6,22,23,5,2,4,21,27,1,3,4,2,1,92,64,156,10,50,6.41025641025641,32.0512820512821,41.025641025641,58.974358974359
"500","84","2",0,2,17,2,15,44,12,1,2,17,42,11,5,8,1,0,95,87,182,0,86,0,47.2527472527473,47.8021978021978,52.1978021978022
"501","84","3",0,0,12,1,12,60,1,1,0,12,60,1,0,2,1,0,88,78,166,0,120,0,72.289156626506,46.9879518072289,53.0120481927711
"502","84","4",1,1,8,2,8,60,3,2,1,9,59,3,2,3,2,2,86,83,169,3,119,1.77514792899408,70.414201183432,49.112426035503,50.887573964497
"503","84","5",0,0,9,1,10,55,4,0,0,11,55,3,1,3,0,0,81,74,155,0,110,0,70.9677419354839,47.741935483871,52.258064516129
"504","84","6",1,3,7,2,7,53,2,0,3,6,52,0,2,0,0,0,76,65,141,1,105,0.709219858156028,74.468085106383,46.0992907801418,53.9007092198582
"505","85","1",2,3,5,4,7,7,3,4,3,6,9,3,2,5,4,2,37,35,72,4,16,5.55555555555556,22.2222222222222,48.6111111111111,51.3888888888889
"506","85","2",2,1,3,0,2,5,2,1,1,2,5,3,1,2,1,2,18,18,36,4,10,11.1111111111111,27.7777777777778,50,50
"507","85","3",2,4,5,2,5,4,3,0,4,3,4,1,2,1,0,0,26,17,43,2,8,4.65116279069767,18.6046511627907,39.5348837209302,60.4651162790698
"508","85","4",0,1,3,2,2,4,6,1,1,4,3,4,3,4,1,0,20,22,42,0,7,0,16.6666666666667,52.3809523809524,47.6190476190476
"509","85","5",0,0,1,1,0,2,1,3,0,2,1,3,2,3,4,9,9,26,35,9,3,25.7142857142857,8.57142857142857,74.2857142857143,25.7142857142857
"510","85","6",0,0,1,0,0,8,2,1,0,1,7,3,1,2,1,0,13,17,30,0,15,0,50,56.6666666666667,43.3333333333333
"511","86","1",0,2,4,2,4,6,3,6,2,4,5,7,2,6,5,2,27,36,63,2,11,3.17460317460317,17.4603174603175,57.1428571428571,42.8571428571429
"512","86","2",0,1,1,0,0,25,6,6,1,0,24,12,1,12,6,6,40,64,104,6,49,5.76923076923077,47.1153846153846,61.5384615384615,38.4615384615385
"513","86","3",0,0,1,0,1,58,2,4,0,1,58,5,0,6,4,1,67,77,144,1,116,0.694444444444444,80.5555555555556,53.4722222222222,46.5277777777778
"514","86","4",0,0,0,0,0,56,1,0,0,0,56,1,0,1,0,0,59,59,118,0,112,0,94.9152542372881,50,50
"515","86","5",0,0,0,1,0,55,1,1,0,1,55,1,1,1,1,0,59,62,121,0,110,0,90.9090909090909,51.2396694214876,48.7603305785124
"516","86","6",0,0,0,0,0,73,0,0,0,0,72,0,0,0,0,0,74,74,148,0,145,0,97.972972972973,50,50
"517","87","1",5,3,7,3,9,17,6,1,3,7,20,4,1,6,1,0,53,43,96,5,37,5.20833333333333,38.5416666666667,44.7916666666667,55.2083333333333
"518","87","2",0,1,3,4,4,13,10,0,1,6,14,5,3,7,0,0,36,38,74,0,27,0,36.4864864864865,51.3513513513514,48.6486486486486
"519","87","3",1,1,3,1,4,6,1,1,1,4,7,1,1,1,1,0,20,17,37,1,13,2.7027027027027,35.1351351351351,45.9459459459459,54.0540540540541
"520","87","4",6,2,5,1,2,13,5,3,2,4,9,7,4,3,3,3,38,37,75,9,22,12,29.3333333333333,49.3333333333333,50.6666666666667
"521","87","5",0,0,2,0,1,13,1,0,0,2,12,0,1,0,0,0,18,17,35,0,25,0,71.4285714285714,48.5714285714286,51.4285714285714
"522","87","6",0,0,1,0,1,7,2,0,0,1,6,2,0,2,0,0,12,13,25,0,13,0,52,52,48
"523","88","1",13,10,22,8,23,20,11,1,10,20,21,4,7,5,1,1,110,70,180,14,41,7.77777777777778,22.7777777777778,38.8888888888889,61.1111111111111
"524","88","2",6,7,33,0,33,28,1,0,7,26,28,1,0,1,0,0,110,64,174,6,56,3.44827586206897,32.183908045977,36.7816091954023,63.2183908045977
"525","88","3",1,3,22,1,20,50,5,0,3,20,47,4,3,2,0,0,103,81,184,1,97,0.543478260869565,52.7173913043478,44.0217391304348,55.9782608695652
"526","88","4",1,1,9,1,10,75,5,0,1,9,76,4,0,5,0,0,104,96,200,1,151,0.5,75.5,48,52
"527","88","5",0,0,4,4,5,67,8,0,0,8,69,4,3,5,0,0,90,90,180,0,136,0,75.5555555555556,50,50
"528","88","6",0,0,3,2,4,53,5,0,0,5,55,3,1,4,0,0,69,69,138,0,108,0,78.2608695652174,50,50
"529","89","1",0,1,5,3,4,38,14,5,1,7,36,16,4,15,5,3,71,89,160,3,74,1.875,46.25,55.625,44.375
"530","89","2",0,0,1,2,3,48,12,0,0,3,49,11,0,12,0,0,67,77,144,0,97,0,67.3611111111111,53.4722222222222,46.5277777777778
"531","89","3",0,0,4,3,5,39,11,2,0,7,39,10,2,11,2,0,65,73,138,0,78,0,56.5217391304348,52.8985507246377,47.1014492753623
"532","89","4",0,0,1,1,1,107,2,0,0,2,107,1,1,1,0,0,114,113,227,0,214,0,94.273127753304,49.7797356828194,50.2202643171806
"533","89","5",0,1,1,1,2,95,1,0,1,1,97,0,0,1,0,0,103,101,204,0,192,0,94.1176470588235,49.5098039215686,50.4901960784314
"534","89","6",0,0,2,0,0,119,2,0,0,2,117,2,2,0,0,0,125,124,249,0,236,0,94.7791164658635,49.7991967871486,50.2008032128514
"535","9","1",3,4,12,2,11,21,5,1,4,10,21,3,3,3,1,1,61,47,108,4,42,3.7037037037037,38.8888888888889,43.5185185185185,56.4814814814815
"536","9","2",3,6,23,1,22,29,0,1,6,18,29,0,1,0,1,0,87,56,143,3,58,2.0979020979021,40.5594405594406,39.1608391608392,60.8391608391608
"537","9","3",0,1,15,1,14,50,2,0,1,15,50,1,1,1,0,0,85,70,155,0,100,0,64.5161290322581,45.1612903225806,54.8387096774194
"538","9","4",0,0,3,0,1,40,11,5,0,3,39,16,2,14,5,2,62,82,144,2,79,1.38888888888889,54.8611111111111,56.9444444444444,43.0555555555556
"539","9","5",0,1,2,0,1,54,11,1,1,1,53,12,1,11,1,0,71,82,153,0,107,0,69.9346405228758,53.5947712418301,46.4052287581699
"540","9","6",0,0,14,1,15,46,2,1,0,15,47,2,0,3,1,1,81,70,151,1,93,0.662251655629139,61.5894039735099,46.3576158940397,53.6423841059603
"541","90","1",2,2,6,4,5,17,9,10,2,8,15,15,5,13,10,14,56,84,140,16,32,11.4285714285714,22.8571428571429,60,40
"542","90","2",0,0,7,4,8,20,12,3,0,11,22,11,3,13,3,2,56,66,122,2,42,1.63934426229508,34.4262295081967,54.0983606557377,45.9016393442623
"543","90","3",0,1,12,5,15,44,6,2,1,16,47,2,2,6,2,0,86,78,164,0,91,0,55.4878048780488,47.5609756097561,52.4390243902439
"544","90","4",0,0,4,1,4,82,2,0,0,5,81,1,1,1,0,0,94,91,185,0,163,0,88.1081081081081,49.1891891891892,50.8108108108108
"545","90","5",1,1,3,0,3,100,0,0,1,2,99,0,0,0,0,0,109,104,213,1,199,0.469483568075117,93.4272300469484,48.8262910798122,51.1737089201878
"546","90","6",0,0,0,0,0,93,0,2,0,0,93,2,0,2,2,4,97,104,201,4,186,1.99004975124378,92.5373134328358,51.7412935323383,48.2587064676617
"547","91","1",15,9,6,12,7,5,7,9,10,9,6,4,12,5,9,13,73,68,141,28,11,19.8581560283688,7.80141843971631,48.2269503546099,51.7730496453901
"548","91","2",0,1,1,4,1,18,18,4,1,4,18,18,4,18,4,4,48,73,121,4,36,3.30578512396694,29.7520661157025,60.3305785123967,39.6694214876033
"549","91","3",1,1,3,1,1,26,5,3,1,2,24,8,2,6,3,2,42,50,92,3,50,3.26086956521739,54.3478260869565,54.3478260869565,45.6521739130435
"550","91","4",0,1,1,3,3,14,4,6,1,3,17,6,1,9,6,0,34,44,78,0,31,0,39.7435897435897,56.4102564102564,43.5897435897436
"551","91","5",0,0,7,0,6,15,4,1,0,7,14,5,1,4,1,0,34,34,68,0,29,0,42.6470588235294,50,50
"552","91","6",5,4,11,3,12,14,3,0,4,10,15,0,2,1,0,0,54,33,87,5,29,5.74712643678161,33.3333333333333,37.9310344827586,62.0689655172414
