"","fish_id","bin","LLLL","LLLR","LLRL","LLRR","LRLL","LRLR","LRRL","LRRR","RLLL","RLLR","RLRL","RLRR","RRLL","RRLR","RRRL","RRRR","L","R","total_turns","reps","alts","rel_reps","rel_alts","rel_R","rel_L"
"1","1","1",57,4,4,1,4,2,1,0,5,1,2,0,2,0,0,0,76,10,86,57,4,66.2790697674419,4.65116279069767,11.6279069767442,88.3720930232558
"2","1","2",74,9,7,2,7,0,2,0,9,0,0,0,2,0,0,0,104,11,115,74,0,64.3478260869565,0,9.56521739130435,90.4347826086957
"3","1","3",42,13,12,7,15,6,7,2,13,6,9,2,4,5,2,2,107,43,150,44,15,29.3333333333333,10,28.6666666666667,71.3333333333333
"4","1","4",31,14,13,4,11,8,4,2,14,3,7,2,5,1,2,1,89,36,125,32,15,25.6,12,28.8,71.2
"5","1","5",40,10,10,3,11,7,2,1,11,2,8,0,2,1,1,0,87,25,112,40,15,35.7142857142857,13.3928571428571,22.3214285714286,77.6785714285714
"6","1","6",28,10,11,2,8,11,3,1,10,2,9,2,4,0,1,0,76,29,105,28,20,26.6666666666667,19.047619047619,27.6190476190476,72.3809523809524
"7","10","1",0,0,1,7,2,2,4,7,0,8,3,4,6,5,7,20,25,54,79,20,5,25.3164556962025,6.32911392405063,68.3544303797468,31.6455696202532
"8","10","2",0,1,2,6,2,1,2,10,1,7,1,6,6,6,10,22,24,62,86,22,2,25.5813953488372,2.32558139534884,72.0930232558139,27.906976744186
"9","10","3",0,1,0,2,1,0,0,3,1,1,0,1,1,1,3,43,8,53,61,43,0,70.4918032786885,0,86.8852459016394,13.1147540983607
"10","10","4",0,0,0,0,0,0,0,3,0,0,0,3,0,3,3,33,3,45,48,33,0,68.75,0,93.75,6.25
"11","10","5",0,0,0,0,0,0,0,1,0,0,0,1,0,2,2,40,2,47,49,40,0,81.6326530612245,0,95.9183673469388,4.08163265306122
"12","10","6",0,0,0,0,0,0,0,2,0,0,1,2,0,3,3,20,4,30,34,20,1,58.8235294117647,2.94117647058824,88.2352941176471,11.7647058823529
"13","100","1",1,4,8,3,7,9,8,0,4,8,7,5,5,3,0,0,42,33,75,1,16,1.33333333333333,21.3333333333333,44,56
"14","100","2",1,2,3,2,3,6,2,4,2,3,6,4,2,4,4,8,24,35,59,9,12,15.2542372881356,20.3389830508475,59.3220338983051,40.6779661016949
"15","100","3",9,5,6,3,6,4,3,3,5,3,4,3,2,4,3,6,40,32,72,15,8,20.8333333333333,11.1111111111111,44.4444444444444,55.5555555555556
"16","100","4",10,6,1,6,1,0,1,6,6,1,0,1,5,1,5,9,31,31,62,19,0,30.6451612903226,0,50,50
"17","100","5",3,1,2,8,2,0,5,8,1,9,0,5,8,5,9,39,30,78,108,42,0,38.8888888888889,0,72.2222222222222,27.7777777777778
"18","100","6",10,10,5,8,6,5,6,10,10,4,6,8,8,9,11,16,62,73,135,26,11,19.2592592592593,8.14814814814815,54.0740740740741,45.9259259259259
"19","101","1",0,0,0,0,0,1293,0,0,0,0,1294,0,0,0,0,0,1295,1295,2590,0,2587,0,99.8841698841699,50,50
"20","101","2",0,0,0,0,0,2266,0,0,0,0,2266,0,0,0,0,0,2267,2268,4535,0,4532,0,99.9338478500551,50.0110253583241,49.9889746416759
"21","101","3",0,0,0,0,0,3354,0,0,0,0,3354,0,0,0,0,0,3356,3355,6711,0,6708,0,99.9552972731337,49.9925495455223,50.0074504544777
"22","101","4",0,0,0,0,0,3892,0,0,0,0,3893,0,0,0,0,0,3894,3894,7788,0,7785,0,99.9614791987673,50,50
"23","101","5",0,0,0,0,0,4008,0,0,0,0,4009,0,0,0,0,0,4010,4010,8020,0,8017,0,99.9625935162095,50,50
"24","101","6",0,0,0,0,0,3530,0,0,0,0,3530,0,0,0,0,0,3531,3532,7063,0,7060,0,99.9575251309642,50.0070791448393,49.9929208551607
"25","11","1",1,3,2,5,4,6,8,8,3,4,8,11,4,12,8,6,39,57,96,7,14,7.29166666666667,14.5833333333333,59.375,40.625
"26","11","2",0,1,1,4,1,3,5,7,1,4,4,8,4,9,8,10,24,49,73,10,7,13.6986301369863,9.58904109589041,67.1232876712329,32.8767123287671
"27","11","3",0,2,4,1,3,7,2,4,3,3,5,5,3,3,4,6,26,32,58,6,12,10.3448275862069,20.6896551724138,55.1724137931034,44.8275862068966
"28","11","4",1,2,2,3,2,0,2,1,2,2,0,0,2,0,0,0,13,9,22,1,0,4.54545454545455,0,40.9090909090909,59.0909090909091
"29","11","5",0,2,1,2,0,2,3,1,2,1,1,3,3,2,1,5,12,20,32,5,3,15.625,9.375,62.5,37.5
"30","11","6",0,0,1,1,1,6,5,2,0,2,6,5,1,5,2,2,17,25,42,2,12,4.76190476190476,28.5714285714286,59.5238095238095,40.4761904761905
"31","12","1",11,12,18,14,22,66,21,13,12,20,69,20,10,24,13,9,178,179,357,20,135,5.60224089635854,37.8151260504202,50.140056022409,49.859943977591
"32","12","2",5,7,10,6,11,24,8,6,7,9,25,8,5,9,6,5,80,74,154,10,49,6.49350649350649,31.8181818181818,48.0519480519481,51.9480519480519
"33","12","3",11,2,4,0,2,10,1,3,2,2,8,4,2,2,3,0,35,24,59,11,18,18.6440677966102,30.5084745762712,40.6779661016949,59.3220338983051
"34","12","4",5,1,2,0,0,7,1,1,0,1,5,2,1,0,0,1,17,13,30,6,12,20,40,43.3333333333333,56.6666666666667
"35","12","5",5,2,1,3,1,8,3,0,2,2,8,0,3,0,0,0,26,15,41,5,16,12.1951219512195,39.0243902439024,36.5853658536585,63.4146341463415
"36","12","6",1,2,8,1,6,28,5,0,2,6,26,5,2,3,0,0,52,46,98,1,54,1.02040816326531,55.1020408163265,46.9387755102041,53.0612244897959
"37","13","1",2,1,1,2,1,2,1,1,1,1,2,0,1,1,1,2,12,11,23,4,4,17.3913043478261,17.3913043478261,47.8260869565217,52.1739130434783
"38","13","2",0,0,0,0,0,14,0,0,0,0,13,0,0,0,0,0,15,15,30,0,27,0,90,50,50
"39","13","3",0,0,0,0,0,32,0,0,0,0,31,0,0,0,0,0,33,33,66,0,63,0,95.4545454545455,50,50
"40","13","4",2,1,2,0,1,24,1,0,1,1,22,1,1,0,0,0,32,28,60,2,46,3.33333333333333,76.6666666666667,46.6666666666667,53.3333333333333
"41","13","5",0,1,2,4,3,1,4,1,1,6,1,1,4,1,1,1,18,17,35,1,2,2.85714285714286,5.71428571428571,48.5714285714286,51.4285714285714
"42","13","6",1,2,3,1,4,1,1,1,2,2,1,1,1,1,1,0,16,10,26,1,2,3.84615384615385,7.69230769230769,38.4615384615385,61.5384615384615
"43","14","1",11,6,12,2,12,24,3,5,5,8,24,6,1,7,5,1,76,59,135,12,48,8.88888888888889,35.5555555555556,43.7037037037037,56.2962962962963
"44","14","2",2,5,6,2,7,42,7,3,5,3,42,8,1,8,3,1,75,73,148,3,84,2.02702702702703,56.7567567567568,49.3243243243243,50.6756756756757
"45","14","3",0,0,0,0,0,30,11,0,0,1,30,11,1,11,1,0,43,56,99,0,60,0,60.6060606060606,56.5656565656566,43.4343434343434
"46","14","4",19,13,12,6,12,4,6,5,14,5,4,4,7,4,5,0,80,43,123,19,8,15.4471544715447,6.50406504065041,34.9593495934959,65.0406504065041
"47","14","5",8,5,7,4,8,13,3,5,5,6,14,4,3,5,5,4,55,47,102,12,27,11.7647058823529,26.4705882352941,46.078431372549,53.921568627451
"48","14","6",20,5,6,8,9,1,7,6,6,9,4,5,5,8,6,2,65,45,110,22,5,20,4.54545454545455,40.9090909090909,59.0909090909091
"49","15","1",14,10,7,7,6,3,7,6,10,4,2,7,7,6,6,8,61,52,113,22,5,19.4690265486726,4.42477876106195,46.0176991150442,53.9823008849558
"50","15","2",8,8,5,10,10,9,10,6,8,7,14,7,5,11,6,1,67,61,128,9,23,7.03125,17.96875,47.65625,52.34375
"51","15","3",35,9,11,4,9,6,4,4,8,7,4,4,6,2,4,1,84,37,121,36,10,29.7520661157025,8.26446280991735,30.5785123966942,69.4214876033058
"52","15","4",10,8,7,6,9,12,8,4,8,5,13,6,4,7,3,1,64,50,114,11,25,9.64912280701754,21.9298245614035,43.859649122807,56.140350877193
"53","15","5",8,6,10,4,6,13,7,7,6,8,9,10,8,6,7,12,63,67,130,20,22,15.3846153846154,16.9230769230769,51.5384615384615,48.4615384615385
"54","15","6",11,8,9,4,7,10,7,2,7,6,8,5,6,3,2,3,60,41,101,14,18,13.8613861386139,17.8217821782178,40.5940594059406,59.4059405940594
"55","16","1",11,9,8,9,11,19,11,5,9,9,21,7,7,9,5,0,85,68,153,11,40,7.18954248366013,26.1437908496732,44.4444444444444,55.5555555555556
"56","16","2",13,7,9,3,7,20,4,4,7,5,18,5,4,3,4,2,68,50,118,15,38,12.7118644067797,32.2033898305085,42.3728813559322,57.6271186440678
"57","16","3",7,3,3,0,3,4,1,0,3,0,4,1,1,1,1,0,23,12,35,7,8,20,22.8571428571429,34.2857142857143,65.7142857142857
"58","16","4",10,3,2,3,4,2,3,1,4,2,4,1,2,2,1,0,31,16,47,10,6,21.2765957446809,12.7659574468085,34.0425531914894,65.9574468085106
"59","16","5",12,5,8,4,7,4,5,1,6,7,3,2,5,1,1,0,49,25,74,12,7,16.2162162162162,9.45945945945946,33.7837837837838,66.2162162162162
"60","16","6",3,1,5,4,5,18,7,3,1,8,18,6,4,6,3,2,47,50,97,5,36,5.15463917525773,37.1134020618557,51.5463917525773,48.4536082474227
"61","17","1",0,1,0,2,0,0,2,4,1,1,0,4,2,4,3,8,9,26,35,8,0,22.8571428571429,0,74.2857142857143,25.7142857142857
"62","17","2",0,0,0,0,0,0,0,1,0,0,0,0,0,0,0,1,1,4,5,1,0,20,0,80,20
"63","17","3",0,0,0,0,0,0,0,0,0,0,0,0,0,0,0,0,0,0,0,0,0,NA,NA,NA,NA
"64","17","4",0,0,0,0,0,0,0,0,0,0,0,0,0,0,0,0,0,0,0,0,0,NA,NA,NA,NA
"65","17","5",0,0,0,0,0,0,0,0,0,0,0,0,0,0,0,0,0,0,0,0,0,NA,NA,NA,NA
"66","17","6",0,0,0,0,0,0,0,0,0,0,0,0,0,0,0,0,0,0,0,0,0,NA,NA,NA,NA
"67","18","1",0,4,9,5,7,9,5,10,4,9,8,10,6,9,10,11,51,68,119,11,17,9.2436974789916,14.2857142857143,57.1428571428571,42.8571428571429
"68","18","2",49,6,6,3,5,3,6,0,7,2,2,3,4,2,0,0,81,20,101,49,5,48.5148514851485,4.95049504950495,19.8019801980198,80.1980198019802
"69","18","3",52,9,8,3,7,2,4,1,8,2,2,2,3,2,1,1,88,22,110,53,4,48.1818181818182,3.63636363636364,20,80
"70","18","4",3,5,5,2,4,17,2,2,5,2,16,2,2,1,2,1,41,33,74,4,33,5.40540540540541,44.5945945945946,44.5945945945946,55.4054054054054
"71","18","5",17,7,7,2,5,11,4,2,7,2,8,4,5,1,2,2,57,32,89,19,19,21.3483146067416,21.3483146067416,35.9550561797753,64.0449438202247
"72","18","6",3,4,2,3,2,22,3,1,4,0,23,1,2,2,1,2,42,36,78,5,45,6.41025641025641,57.6923076923077,46.1538461538462,53.8461538461538
"73","19","1",4,1,0,1,1,0,1,0,2,0,0,0,1,0,0,0,11,3,14,4,0,28.5714285714286,0,21.4285714285714,78.5714285714286
"74","19","2",0,0,0,0,0,0,0,0,0,0,0,0,0,0,0,0,0,0,0,0,0,NA,NA,NA,NA
"75","19","3",0,0,0,0,0,0,0,0,0,0,0,0,0,0,0,0,0,0,0,0,0,NA,NA,NA,NA
"76","19","4",0,0,0,0,0,0,0,0,0,0,0,0,0,0,0,0,0,1,1,0,0,0,0,100,0
"77","19","5",0,0,0,0,0,0,0,0,0,0,0,0,0,0,0,0,0,0,0,0,0,NA,NA,NA,NA
"78","19","6",0,0,0,0,0,0,0,0,0,0,0,0,0,0,0,0,0,0,0,0,0,NA,NA,NA,NA
"79","2","1",0,0,1,2,1,10,3,6,0,3,10,7,1,7,5,13,23,49,72,13,20,18.0555555555556,27.7777777777778,68.0555555555556,31.9444444444444
"80","2","2",0,1,0,3,1,1,2,3,1,2,2,2,2,3,3,25,11,43,54,25,3,46.2962962962963,5.55555555555556,79.6296296296296,20.3703703703704
"81","2","3",0,1,2,3,2,1,3,2,1,4,1,2,3,2,3,7,15,25,40,7,2,17.5,5,62.5,37.5
"82","2","4",0,1,0,1,0,2,1,3,1,0,2,3,2,2,3,5,10,19,29,5,4,17.2413793103448,13.7931034482759,65.5172413793103,34.4827586206897
"83","2","5",0,0,0,1,0,0,0,4,0,1,0,3,1,3,4,5,5,20,25,5,0,20,0,80,20
"84","2","6",0,0,1,0,0,4,0,1,0,1,3,1,1,0,1,3,6,13,19,3,7,15.7894736842105,36.8421052631579,68.4210526315789,31.5789473684211
"85","20","1",19,13,12,10,13,17,10,7,13,10,17,7,10,7,7,5,103,77,180,24,34,13.3333333333333,18.8888888888889,42.7777777777778,57.2222222222222
"86","20","2",8,8,11,9,11,16,6,9,8,12,17,6,8,7,9,9,80,77,157,17,33,10.828025477707,21.0191082802548,49.0445859872611,50.9554140127389
"87","20","3",9,10,15,3,15,25,5,2,10,8,26,4,2,5,2,0,86,58,144,9,51,6.25,35.4166666666667,40.2777777777778,59.7222222222222
"88","20","4",15,8,11,5,10,18,4,3,8,8,17,2,5,1,2,1,74,47,121,16,35,13.2231404958678,28.9256198347107,38.8429752066116,61.1570247933884
"89","20","5",5,7,5,8,8,10,3,8,7,6,13,3,5,6,8,2,56,51,107,7,23,6.54205607476636,21.4953271028037,47.6635514018692,52.3364485981308
"90","20","6",9,5,7,2,7,4,2,2,5,4,4,2,2,2,2,1,39,24,63,10,8,15.8730158730159,12.6984126984127,38.0952380952381,61.9047619047619
"91","21","1",1,1,1,4,1,11,8,13,1,4,10,17,4,17,13,27,41,95,136,28,21,20.5882352941176,15.4411764705882,69.8529411764706,30.1470588235294
"92","21","2",1,1,4,4,3,4,6,10,1,7,3,12,5,11,10,27,33,79,112,28,7,25,6.25,70.5357142857143,29.4642857142857
"93","21","3",0,1,1,1,1,11,6,10,1,1,11,15,1,15,10,20,31,77,108,20,22,18.5185185185185,20.3703703703704,71.2962962962963,28.7037037037037
"94","21","4",0,1,3,3,2,3,2,6,1,5,2,5,4,4,5,46,20,75,95,46,5,48.4210526315789,5.26315789473684,78.9473684210526,21.0526315789474
"95","21","5",0,0,1,2,0,3,2,7,0,3,2,8,3,7,8,39,16,72,88,39,5,44.3181818181818,5.68181818181818,81.8181818181818,18.1818181818182
"96","21","6",0,0,0,1,1,2,1,6,0,1,3,6,0,8,7,59,12,86,98,59,5,60.2040816326531,5.10204081632653,87.7551020408163,12.2448979591837
"97","22","1",0,2,2,1,2,2,0,3,2,1,1,2,1,1,3,14,13,27,40,14,3,35,7.5,67.5,32.5
"98","22","2",0,0,0,1,0,2,0,1,0,1,2,0,1,1,1,1,5,9,14,1,4,7.14285714285714,28.5714285714286,64.2857142857143,35.7142857142857
"99","22","3",0,0,0,0,0,6,0,0,0,0,5,0,0,0,0,0,7,7,14,0,11,0,78.5714285714286,50,50
"100","22","4",0,0,0,0,0,8,0,0,0,0,7,0,0,0,0,0,9,9,18,0,15,0,83.3333333333333,50,50
"101","22","5",0,0,0,0,0,4,0,0,0,0,3,0,0,0,0,0,5,5,10,0,7,0,70,50,50
"102","22","6",0,0,0,0,0,1,0,0,0,0,1,0,0,0,0,0,3,2,5,0,2,0,40,40,60
"103","23","1",12,7,10,5,10,12,8,2,7,8,12,5,5,5,2,0,69,44,113,12,24,10.6194690265487,21.2389380530973,38.9380530973451,61.0619469026549
"104","23","2",11,8,17,4,16,7,6,2,7,13,6,4,5,3,2,0,73,41,114,11,13,9.64912280701754,11.4035087719298,35.9649122807018,64.0350877192982
"105","23","3",25,7,6,3,6,2,2,2,6,2,2,1,2,1,1,1,53,19,72,26,4,36.1111111111111,5.55555555555556,26.3888888888889,73.6111111111111
"106","23","4",19,6,4,4,5,2,3,1,6,2,4,0,2,2,1,0,46,18,64,19,6,29.6875,9.375,28.125,71.875
"107","23","5",4,3,2,2,4,0,0,2,4,1,1,0,1,1,2,1,20,11,31,5,1,16.1290322580645,3.2258064516129,35.4838709677419,64.5161290322581
"108","23","6",11,3,6,1,5,7,1,1,3,4,6,0,2,0,1,0,36,18,54,11,13,20.3703703703704,24.0740740740741,33.3333333333333,66.6666666666667
"109","24","1",2,2,4,4,4,8,8,15,2,6,9,19,4,20,16,50,49,127,176,52,17,29.5454545454545,9.65909090909091,72.1590909090909,27.8409090909091
"110","24","2",1,1,4,1,2,6,3,17,1,4,4,19,3,18,17,31,36,99,135,32,10,23.7037037037037,7.40740740740741,73.3333333333333,26.6666666666667
"111","24","3",0,0,4,3,3,11,4,15,0,7,11,16,4,16,16,39,42,110,152,39,22,25.6578947368421,14.4736842105263,72.3684210526316,27.6315789473684
"112","24","4",1,3,5,5,4,8,2,13,3,7,7,10,6,9,12,19,41,76,117,20,15,17.0940170940171,12.8205128205128,64.957264957265,35.042735042735
"113","24","5",1,4,7,6,7,7,6,5,4,9,7,5,6,6,6,10,44,55,99,11,14,11.1111111111111,14.1414141414141,55.5555555555556,44.4444444444444
"114","24","6",8,7,6,7,10,3,4,8,7,6,7,4,3,9,8,7,54,53,107,15,10,14.018691588785,9.34579439252336,49.5327102803738,50.4672897196262
"115","25","1",0,0,0,1,0,4,3,0,0,1,5,1,1,2,0,0,10,11,21,0,9,0,42.8571428571429,52.3809523809524,47.6190476190476
"116","25","2",0,0,0,0,0,0,0,0,0,0,0,0,0,0,0,0,1,1,2,0,0,0,0,50,50
"117","25","3",0,0,0,2,1,7,1,5,0,2,8,4,1,5,5,7,16,35,51,7,15,13.7254901960784,29.4117647058824,68.6274509803922,31.3725490196078
"118","25","4",2,1,0,3,0,0,2,4,1,2,0,4,3,4,5,10,13,31,44,12,0,27.2727272727273,0,70.4545454545455,29.5454545454545
"119","25","5",0,0,0,0,0,0,1,1,0,0,0,2,0,3,2,14,3,23,26,14,0,53.8461538461538,0,88.4615384615385,11.5384615384615
"120","25","6",0,0,0,1,0,0,0,1,0,1,0,0,0,1,1,2,3,7,10,2,0,20,0,70,30
"121","26","1",3,3,15,1,16,16,2,1,3,14,17,2,1,3,1,6,59,48,107,9,33,8.41121495327103,30.8411214953271,44.8598130841121,55.1401869158879
"122","26","2",4,2,4,5,4,9,4,7,2,7,9,6,4,6,6,6,39,49,88,10,18,11.3636363636364,20.4545454545455,55.6818181818182,44.3181818181818
"123","26","3",0,0,3,4,3,12,5,6,0,7,12,7,4,7,6,7,34,52,86,7,24,8.13953488372093,27.906976744186,60.4651162790698,39.5348837209302
"124","26","4",3,4,5,4,5,7,2,2,4,4,7,1,3,1,2,0,33,24,57,3,14,5.26315789473684,24.5614035087719,42.1052631578947,57.8947368421053
"125","26","5",6,2,2,2,3,9,6,1,2,2,10,4,1,6,1,1,32,29,61,7,19,11.4754098360656,31.1475409836066,47.5409836065574,52.4590163934426
"126","26","6",0,1,5,4,4,9,5,2,1,8,7,4,5,2,2,9,31,40,71,9,16,12.6760563380282,22.5352112676056,56.3380281690141,43.6619718309859
"127","27","1",8,10,15,3,13,13,6,7,10,8,11,9,5,8,7,3,76,63,139,11,24,7.9136690647482,17.2661870503597,45.3237410071942,54.6762589928058
"128","27","2",7,5,5,5,3,4,7,5,5,5,3,6,7,5,5,5,43,42,85,12,7,14.1176470588235,8.23529411764706,49.4117647058824,50.5882352941176
"129","27","3",3,4,3,0,2,1,2,0,4,0,0,2,2,1,1,0,17,11,28,3,1,10.7142857142857,3.57142857142857,39.2857142857143,60.7142857142857
"130","27","4",4,2,3,1,2,0,3,0,2,2,0,2,2,2,1,0,17,12,29,4,0,13.7931034482759,0,41.3793103448276,58.6206896551724
"131","27","5",0,0,1,1,1,0,1,0,0,1,0,0,0,1,0,0,5,4,9,0,0,0,0,44.4444444444444,55.5555555555556
"132","27","6",1,1,1,1,1,1,0,1,1,1,1,0,0,0,1,1,8,7,15,2,2,13.3333333333333,13.3333333333333,46.6666666666667,53.3333333333333
"133","28","1",21,11,6,6,10,8,7,4,11,1,12,5,3,8,4,3,75,48,123,24,20,19.5121951219512,16.260162601626,39.0243902439024,60.9756097560976
"134","28","2",33,8,8,4,9,3,4,2,8,4,4,2,3,3,2,0,74,26,100,33,7,33,7,26,74
"135","28","3",26,6,5,3,5,3,3,0,6,2,3,1,3,0,0,0,52,17,69,26,6,37.6811594202899,8.69565217391304,24.6376811594203,75.3623188405797
"136","28","4",4,4,9,0,9,6,0,1,5,4,6,1,0,1,1,1,36,19,55,5,12,9.09090909090909,21.8181818181818,34.5454545454545,65.4545454545455
"137","28","5",10,2,6,2,6,4,0,3,2,5,4,1,2,1,3,0,35,19,54,10,8,18.5185185185185,14.8148148148148,35.1851851851852,64.8148148148148
"138","28","6",12,9,5,4,4,3,6,2,9,0,2,4,5,3,2,0,46,27,73,12,5,16.4383561643836,6.84931506849315,36.986301369863,63.013698630137
"139","29","1",0,1,2,1,2,3,0,3,1,2,3,2,0,2,3,7,13,22,35,7,6,20,17.1428571428571,62.8571428571429,37.1428571428571
"140","29","2",0,0,0,0,0,0,0,0,0,0,0,0,0,0,0,0,0,3,3,0,0,0,0,100,0
"141","29","3",0,0,0,0,0,0,0,1,0,0,0,1,0,1,1,31,1,37,38,31,0,81.5789473684211,0,97.3684210526316,2.63157894736842
"142","29","4",0,0,0,0,0,0,0,2,0,0,0,2,0,3,3,48,3,58,61,48,0,78.6885245901639,0,95.0819672131148,4.91803278688525
"143","29","5",0,0,0,2,0,0,0,4,0,2,0,2,2,3,5,12,7,28,35,12,0,34.2857142857143,0,80,20
"144","29","6",0,0,0,0,0,0,0,3,0,0,0,2,0,2,2,25,3,34,37,25,0,67.5675675675676,0,91.8918918918919,8.10810810810811
"145","3","1",1,5,6,2,6,39,6,2,5,3,38,6,2,6,2,1,68,65,133,2,77,1.50375939849624,57.8947368421053,48.8721804511278,51.1278195488722
"146","3","2",0,0,3,1,2,30,4,3,0,4,28,6,2,4,3,1,44,50,94,1,58,1.06382978723404,61.7021276595745,53.1914893617021,46.8085106382979
"147","3","3",5,3,8,3,6,10,5,1,3,8,7,3,5,0,1,2,42,31,73,7,17,9.58904109589041,23.2876712328767,42.4657534246575,57.5342465753425
"148","3","4",1,1,4,1,3,13,3,0,1,4,12,2,2,1,0,0,28,23,51,1,25,1.96078431372549,49.0196078431373,45.0980392156863,54.9019607843137
"149","3","5",4,2,5,2,5,26,3,1,2,4,26,2,1,2,1,2,49,42,91,6,52,6.59340659340659,57.1428571428571,46.1538461538462,53.8461538461538
"150","3","6",37,3,5,0,6,6,0,0,4,2,6,0,0,0,0,0,60,12,72,37,12,51.3888888888889,16.6666666666667,16.6666666666667,83.3333333333333
"151","30","1",3,3,11,3,8,25,5,6,3,11,21,8,6,5,6,7,65,69,134,10,46,7.46268656716418,34.3283582089552,51.4925373134328,48.5074626865672
"152","30","2",0,0,0,0,0,2,0,0,0,0,1,1,0,0,0,0,3,4,7,0,3,0,42.8571428571429,57.1428571428571,42.8571428571429
"153","30","3",0,0,0,1,1,0,0,1,0,1,1,0,0,1,1,0,4,6,10,0,1,0,10,60,40
"154","30","4",0,0,0,0,0,0,0,0,0,0,0,0,0,0,0,0,0,0,0,0,0,NA,NA,NA,NA
"155","30","5",0,0,1,0,1,2,0,0,0,1,1,1,0,0,0,0,5,5,10,0,3,0,30,50,50
"156","30","6",0,1,0,0,0,0,1,0,1,0,0,0,1,0,0,0,4,3,7,0,0,0,0,42.8571428571429,57.1428571428571
"157","31","1",5,3,5,2,5,11,3,1,4,4,10,2,3,1,1,0,38,25,63,5,21,7.93650793650794,33.3333333333333,39.6825396825397,60.3174603174603
"158","31","2",8,9,6,9,9,6,7,5,9,6,9,3,6,6,5,9,61,54,115,17,15,14.7826086956522,13.0434782608696,46.9565217391304,53.0434782608696
"159","31","3",4,4,3,6,2,13,15,3,4,5,12,12,7,12,3,0,51,57,108,4,25,3.7037037037037,23.1481481481481,52.7777777777778,47.2222222222222
"160","31","4",9,6,12,2,12,8,6,2,6,8,8,5,2,5,1,0,57,38,95,9,16,9.47368421052632,16.8421052631579,40,60
"161","31","5",3,4,4,4,4,3,5,2,5,4,3,3,4,3,2,3,32,27,59,6,6,10.1694915254237,10.1694915254237,45.7627118644068,54.2372881355932
"162","31","6",4,4,3,3,2,4,2,2,4,2,3,2,4,1,2,1,25,21,46,5,7,10.8695652173913,15.2173913043478,45.6521739130435,54.3478260869565
"163","32","1",8,11,14,8,17,24,10,12,12,11,27,13,6,16,12,15,107,112,219,23,51,10.5022831050228,23.2876712328767,51.1415525114155,48.8584474885845
"164","32","2",9,14,18,4,17,37,10,5,14,9,36,11,6,10,6,1,116,94,210,10,73,4.76190476190476,34.7619047619048,44.7619047619048,55.2380952380952
"165","32","3",2,6,14,4,13,46,11,7,6,12,45,14,5,12,6,6,103,109,212,8,91,3.77358490566038,42.9245283018868,51.4150943396226,48.5849056603774
"166","32","4",4,8,12,3,12,60,6,3,7,7,61,6,2,7,3,2,110,96,206,6,121,2.9126213592233,58.7378640776699,46.6019417475728,53.3980582524272
"167","32","5",4,6,11,2,13,108,5,3,6,7,109,6,0,8,3,0,153,141,294,4,217,1.36054421768707,73.8095238095238,47.9591836734694,52.0408163265306
"168","32","6",1,1,2,1,2,241,2,5,1,2,242,6,1,6,5,4,257,268,525,5,483,0.952380952380952,92,51.0476190476191,48.9523809523809
"169","33","1",2,4,9,3,5,6,5,7,4,8,3,8,7,5,7,9,43,52,95,11,9,11.5789473684211,9.47368421052632,54.7368421052632,45.2631578947368
"170","33","2",15,13,12,8,11,14,13,5,13,7,13,10,9,9,5,6,94,72,166,21,27,12.6506024096386,16.2650602409639,43.3734939759036,56.6265060240964
"171","33","3",10,6,13,4,13,10,4,3,6,11,9,3,4,2,3,3,64,43,107,13,19,12.1495327102804,17.7570093457944,40.1869158878505,59.8130841121495
"172","33","4",10,9,4,6,5,2,7,3,9,1,3,4,5,5,3,2,48,33,81,12,5,14.8148148148148,6.17283950617284,40.7407407407407,59.2592592592593
"173","33","5",11,4,10,2,9,8,6,0,4,8,8,3,3,3,0,0,52,30,82,11,16,13.4146341463415,19.5121951219512,36.5853658536585,63.4146341463415
"174","33","6",17,10,10,1,11,8,1,0,10,1,9,0,0,1,0,0,61,21,82,17,17,20.7317073170732,20.7317073170732,25.609756097561,74.390243902439
"175","34","1",6,6,3,8,1,11,10,10,6,5,8,12,10,10,10,11,56,74,130,17,19,13.0769230769231,14.6153846153846,56.9230769230769,43.0769230769231
"176","34","2",7,10,11,7,15,13,8,1,10,9,17,2,3,6,1,4,74,53,127,11,30,8.66141732283465,23.6220472440945,41.7322834645669,58.2677165354331
"177","34","3",15,8,13,3,8,9,7,1,7,8,4,5,7,1,1,0,65,35,100,15,13,15,13,35,65
"178","34","4",2,6,6,3,7,10,2,5,6,3,11,4,3,4,5,6,43,43,86,8,21,9.30232558139535,24.4186046511628,50,50
"179","34","5",0,1,4,7,5,7,5,6,1,10,8,5,6,6,7,5,36,50,86,5,15,5.81395348837209,17.4418604651163,58.1395348837209,41.8604651162791
"180","34","6",2,3,11,3,11,14,5,4,4,11,14,5,4,5,4,1,56,48,104,3,28,2.88461538461538,26.9230769230769,46.1538461538462,53.8461538461538
"181","35","1",2,1,1,3,3,2,2,8,1,3,3,7,1,8,7,13,22,46,68,15,5,22.0588235294118,7.35294117647059,67.6470588235294,32.3529411764706
"182","35","2",3,1,1,1,0,3,1,4,1,1,2,4,2,3,3,16,14,35,49,19,5,38.7755102040816,10.2040816326531,71.4285714285714,28.5714285714286
"183","35","3",1,2,2,4,1,5,4,8,2,4,4,9,5,8,9,14,28,57,85,15,9,17.6470588235294,10.5882352941176,67.0588235294118,32.9411764705882
"184","35","4",0,0,1,3,0,4,3,9,0,4,3,9,4,9,9,17,21,57,78,17,7,21.7948717948718,8.97435897435897,73.0769230769231,26.9230769230769
"185","35","5",0,0,0,2,0,1,3,9,0,2,1,10,2,9,8,37,15,72,87,37,2,42.5287356321839,2.29885057471264,82.7586206896552,17.2413793103448
"186","35","6",2,1,1,2,1,2,0,7,1,2,2,4,2,4,6,52,16,76,92,54,4,58.695652173913,4.34782608695652,82.6086956521739,17.3913043478261
"187","36","1",5,4,3,4,3,6,4,6,3,3,6,6,3,6,6,5,36,40,76,10,12,13.1578947368421,15.7894736842105,52.6315789473684,47.3684210526316
"188","36","2",0,0,0,0,0,0,1,3,0,1,0,4,1,3,3,5,6,18,24,5,0,20.8333333333333,0,75,25
"189","36","3",11,3,1,1,1,1,2,1,3,0,0,2,2,1,1,4,23,14,37,15,1,40.5405405405405,2.7027027027027,37.8378378378378,62.1621621621622
"190","36","4",63,10,9,2,9,1,1,1,10,1,1,0,2,0,1,0,99,15,114,63,2,55.2631578947368,1.75438596491228,13.1578947368421,86.8421052631579
"191","36","5",31,12,17,2,15,10,3,1,12,7,8,2,4,0,1,0,94,34,128,31,18,24.21875,14.0625,26.5625,73.4375
"192","36","6",25,13,14,5,15,9,3,3,14,6,10,1,4,2,3,2,90,42,132,27,19,20.4545454545455,14.3939393939394,31.8181818181818,68.1818181818182
"193","37","1",3,5,6,2,5,3,4,3,6,2,2,5,3,4,3,4,34,29,63,7,5,11.1111111111111,7.93650793650794,46.031746031746,53.968253968254
"194","37","2",0,0,0,0,0,0,0,1,0,0,0,1,1,0,1,2,3,6,9,2,0,22.2222222222222,0,66.6666666666667,33.3333333333333
"195","37","3",11,2,2,1,2,2,1,0,2,1,2,0,1,0,0,0,23,7,30,11,4,36.6666666666667,13.3333333333333,23.3333333333333,76.6666666666667
"196","37","4",6,7,7,6,10,7,6,1,7,6,10,2,3,5,1,2,51,38,89,8,17,8.98876404494382,19.1011235955056,42.6966292134831,57.3033707865169
"197","37","5",35,7,7,2,8,2,1,1,8,2,2,0,2,0,1,2,66,17,83,37,4,44.578313253012,4.81927710843374,20.4819277108434,79.5180722891566
"198","37","6",51,6,5,1,6,2,1,0,6,0,3,0,0,1,0,0,75,10,85,51,5,60,5.88235294117647,11.7647058823529,88.2352941176471
"199","38","1",18,5,5,5,5,2,4,4,5,5,2,3,4,3,4,1,49,29,78,19,4,24.3589743589744,5.12820512820513,37.1794871794872,62.8205128205128
"200","38","2",1,1,0,3,1,1,3,2,1,2,2,2,2,3,2,2,13,18,31,3,3,9.67741935483871,9.67741935483871,58.0645161290323,41.9354838709677
"201","38","3",0,0,0,0,0,0,0,3,0,0,0,3,0,2,2,48,3,58,61,48,0,78.6885245901639,0,95.0819672131148,4.91803278688525
"202","38","4",0,0,0,0,0,0,0,2,0,0,0,2,0,2,2,29,2,38,40,29,0,72.5,0,95,5
"203","38","5",0,0,0,1,0,0,0,1,0,1,0,0,1,0,1,61,2,67,69,61,0,88.4057971014493,0,97.1014492753623,2.89855072463768
"204","38","6",0,0,0,1,0,0,0,2,0,1,0,1,1,1,2,45,3,54,57,45,0,78.9473684210526,0,94.7368421052632,5.26315789473684
"205","39","1",16,7,8,7,8,15,17,4,7,7,16,14,6,15,4,4,84,74,158,20,31,12.6582278481013,19.620253164557,46.8354430379747,53.1645569620253
"206","39","2",1,1,5,5,3,21,10,11,1,9,19,16,8,14,11,21,59,100,159,22,40,13.8364779874214,25.1572327044025,62.8930817610063,37.1069182389937
"207","39","3",7,9,4,11,7,13,10,8,9,6,15,7,9,9,8,3,71,67,138,10,28,7.2463768115942,20.2898550724638,48.5507246376812,51.4492753623188
"208","39","4",9,5,11,4,6,18,11,4,6,10,13,10,10,5,4,2,71,60,131,11,31,8.3969465648855,23.6641221374046,45.8015267175573,54.1984732824427
"209","39","5",6,7,9,9,9,8,8,9,7,11,9,7,9,8,9,1,67,62,129,7,17,5.42635658914729,13.1782945736434,48.062015503876,51.937984496124
"210","39","6",4,7,13,5,11,20,15,4,7,11,19,13,7,12,4,3,81,77,158,7,39,4.43037974683544,24.6835443037975,48.7341772151899,51.2658227848101
"211","4","1",2,5,8,7,10,4,7,4,5,9,6,4,4,6,4,4,48,44,92,6,10,6.52173913043478,10.8695652173913,47.8260869565217,52.1739130434783
"212","4","2",57,5,7,1,8,1,1,1,5,4,2,1,1,2,2,5,83,23,106,62,3,58.4905660377358,2.83018867924528,21.6981132075472,78.3018867924528
"213","4","3",3,3,5,0,4,17,2,0,3,2,16,1,1,1,0,0,35,26,61,3,33,4.91803278688525,54.0983606557377,42.6229508196721,57.3770491803279
"214","4","4",4,1,4,1,2,15,4,0,1,4,13,2,3,1,0,0,32,26,58,4,28,6.89655172413793,48.2758620689655,44.8275862068966,55.1724137931034
"215","4","5",0,0,2,1,2,16,2,2,0,4,15,3,2,2,2,4,27,33,60,4,31,6.66666666666667,51.6666666666667,55,45
"216","4","6",4,1,1,0,1,10,1,1,1,0,11,1,0,2,1,0,21,17,38,4,21,10.5263157894737,55.2631578947368,44.7368421052632,55.2631578947368
"217","40","1",2,4,5,0,6,0,0,0,4,2,0,0,0,0,0,0,19,7,26,2,0,7.69230769230769,0,26.9230769230769,73.0769230769231
"218","40","2",1,1,1,0,0,1,0,0,0,0,0,0,0,0,0,0,5,2,7,1,1,14.2857142857143,14.2857142857143,28.5714285714286,71.4285714285714
"219","40","3",0,0,0,0,0,0,0,0,0,0,0,0,0,0,0,0,0,0,0,0,0,NA,NA,NA,NA
"220","40","4",0,0,0,0,0,0,0,0,0,0,0,0,0,0,0,0,0,0,0,0,0,NA,NA,NA,NA
"221","40","5",0,0,0,0,0,0,0,0,0,0,0,0,0,0,0,0,1,1,2,0,0,0,0,50,50
"222","40","6",0,0,0,0,0,0,0,0,0,0,0,0,0,0,0,0,0,1,1,0,0,0,0,100,0
"223","41","1",0,1,2,0,2,1,0,0,1,1,1,0,1,0,1,1,8,7,15,1,2,6.66666666666667,13.3333333333333,46.6666666666667,53.3333333333333
"224","41","2",2,1,0,1,1,0,1,0,2,0,0,0,1,0,0,0,9,3,12,2,0,16.6666666666667,0,25,75
"225","41","3",0,1,0,0,0,0,0,0,0,0,0,0,0,0,0,0,3,1,4,0,0,0,0,25,75
"226","41","4",9,0,0,0,0,0,0,0,0,0,0,0,0,0,0,0,12,0,12,9,0,75,0,0,100
"227","41","5",21,2,2,0,2,1,0,1,3,0,0,1,1,0,1,0,32,6,38,21,1,55.2631578947368,2.63157894736842,15.7894736842105,84.2105263157895
"228","41","6",33,2,4,0,4,3,0,0,2,2,3,0,0,0,0,0,49,7,56,33,6,58.9285714285714,10.7142857142857,12.5,87.5
"229","42","1",1,5,8,5,7,10,8,8,4,8,9,11,5,10,7,22,52,79,131,23,19,17.5572519083969,14.5038167938931,60.3053435114504,39.6946564885496
"230","42","2",8,8,8,3,6,7,4,5,8,4,5,6,6,3,5,4,51,42,93,12,12,12.9032258064516,12.9032258064516,45.1612903225806,54.8387096774194
"231","42","3",6,6,3,8,5,5,4,4,6,5,7,1,6,3,5,2,42,37,79,8,12,10.126582278481,15.1898734177215,46.8354430379747,53.1645569620253
"232","42","4",4,5,4,4,7,10,2,5,4,3,13,3,0,6,4,4,41,40,81,8,23,9.87654320987654,28.3950617283951,49.3827160493827,50.6172839506173
"233","42","5",17,6,9,4,11,9,4,3,6,7,11,3,3,5,4,1,65,41,106,18,20,16.9811320754717,18.8679245283019,38.6792452830189,61.3207547169811
"234","42","6",6,9,10,7,8,16,11,5,9,8,15,9,8,8,5,5,74,68,142,11,31,7.74647887323944,21.830985915493,47.887323943662,52.112676056338
"235","43","1",0,0,0,2,0,0,1,3,0,2,0,1,2,1,3,4,7,15,22,4,0,18.1818181818182,0,68.1818181818182,31.8181818181818
"236","43","2",0,0,0,0,0,0,0,0,0,0,0,0,0,0,0,0,0,0,0,0,0,NA,NA,NA,NA
"237","43","3",0,0,0,0,0,0,0,0,0,0,0,0,0,0,0,0,0,0,0,0,0,NA,NA,NA,NA
"238","43","4",0,0,0,0,0,0,0,0,0,0,0,0,0,0,0,0,0,0,0,0,0,NA,NA,NA,NA
"239","43","5",0,0,0,0,0,0,0,0,0,0,0,0,0,0,0,0,0,0,0,0,0,NA,NA,NA,NA
"240","43","6",0,0,0,0,0,0,0,0,0,0,0,0,0,0,0,0,0,0,0,0,0,NA,NA,NA,NA
"241","44","1",1,3,1,4,3,2,6,2,3,2,4,4,2,7,2,2,23,28,51,3,6,5.88235294117647,11.7647058823529,54.9019607843137,45.0980392156863
"242","44","2",0,0,0,1,0,0,0,0,0,0,0,0,0,0,0,0,2,2,4,0,0,0,0,50,50
"243","44","3",0,0,0,0,0,0,0,0,0,0,0,0,0,0,0,0,0,0,0,0,0,NA,NA,NA,NA
"244","44","4",0,0,0,0,0,0,0,0,0,0,0,0,0,0,0,0,2,0,2,0,0,0,0,0,100
"245","44","5",1,0,0,0,1,0,0,0,1,0,0,0,0,0,0,0,5,1,6,1,0,16.6666666666667,0,16.6666666666667,83.3333333333333
"246","44","6",10,3,3,1,3,2,1,1,2,1,2,1,0,2,1,0,25,11,36,10,4,27.7777777777778,11.1111111111111,30.5555555555556,69.4444444444444
"247","45","1",4,5,6,6,4,7,7,8,5,7,4,9,8,6,8,14,48,63,111,18,11,16.2162162162162,9.90990990990991,56.7567567567568,43.2432432432432
"248","45","2",6,6,7,3,6,7,8,4,6,5,6,9,5,8,4,2,49,46,95,8,13,8.42105263157895,13.6842105263158,48.4210526315789,51.5789473684211
"249","45","3",1,1,4,1,5,25,2,1,1,5,25,2,1,2,1,1,42,39,81,2,50,2.46913580246914,61.7283950617284,48.1481481481481,51.8518518518519
"250","45","4",9,7,6,5,7,12,8,0,7,4,12,4,4,4,0,0,55,37,92,9,24,9.78260869565217,26.0869565217391,40.2173913043478,59.7826086956522
"251","45","5",0,1,4,2,3,23,4,3,1,5,22,5,3,4,3,3,42,47,89,3,45,3.37078651685393,50.561797752809,52.8089887640449,47.1910112359551
"252","45","6",3,4,6,1,7,23,2,0,4,3,25,0,0,2,0,0,48,35,83,3,48,3.6144578313253,57.8313253012048,42.1686746987952,57.8313253012048
"253","46","1",2,2,1,2,2,4,2,3,2,1,4,3,1,3,3,2,19,21,40,4,8,10,20,52.5,47.5
"254","46","2",0,0,0,0,0,0,0,1,0,0,0,1,0,1,1,5,2,10,12,5,0,41.6666666666667,0,83.3333333333333,16.6666666666667
"255","46","3",0,0,0,0,0,0,0,0,0,0,0,0,0,0,0,0,0,0,0,0,0,NA,NA,NA,NA
"256","46","4",0,0,0,2,0,0,2,8,0,2,0,7,2,7,7,29,12,57,69,29,0,42.0289855072464,0,82.6086956521739,17.3913043478261
"257","46","5",0,0,0,0,0,0,0,2,0,0,0,2,0,2,2,10,2,19,21,10,0,47.6190476190476,0,90.4761904761905,9.52380952380952
"258","46","6",0,0,0,0,0,0,1,4,0,0,0,5,0,5,4,45,5,62,67,45,0,67.1641791044776,0,92.5373134328358,7.46268656716418
"259","47","1",9,5,2,8,4,4,7,7,5,6,6,5,7,7,7,5,48,49,97,14,10,14.4329896907216,10.3092783505155,50.5154639175258,49.4845360824742
"260","47","2",7,6,6,11,5,6,5,13,5,11,5,7,11,7,13,9,60,70,130,16,11,12.3076923076923,8.46153846153846,53.8461538461538,46.1538461538462
"261","47","3",2,4,5,5,6,14,6,6,4,7,15,7,5,8,6,17,50,70,120,19,29,15.8333333333333,24.1666666666667,58.3333333333333,41.6666666666667
"262","47","4",2,6,5,6,3,15,9,6,6,5,12,10,8,7,6,14,53,70,123,16,27,13.0081300813008,21.9512195121951,56.9105691056911,43.0894308943089
"263","47","5",3,5,5,8,4,11,8,10,5,8,10,10,9,9,10,6,55,69,124,9,21,7.25806451612903,16.9354838709677,55.6451612903226,44.3548387096774
"264","47","6",1,2,7,5,4,8,8,7,2,9,5,10,7,8,7,5,43,55,98,6,13,6.12244897959184,13.265306122449,56.1224489795918,43.8775510204082
"265","48","1",1,1,2,0,1,4,1,3,1,0,3,4,0,3,3,9,14,25,39,10,7,25.6410256410256,17.9487179487179,64.1025641025641,35.8974358974359
"266","48","2",0,0,0,0,0,0,0,0,0,0,0,0,0,0,0,0,0,2,2,0,0,0,0,100,0
"267","48","3",0,0,0,0,0,0,0,0,0,0,0,0,0,0,0,0,0,0,0,0,0,NA,NA,NA,NA
"268","48","4",0,0,0,0,0,0,0,0,0,0,0,0,0,0,0,0,0,0,0,0,0,NA,NA,NA,NA
"269","48","5",0,0,0,0,0,0,0,0,0,0,0,0,0,0,0,0,0,0,0,0,0,NA,NA,NA,NA
"270","48","6",0,0,0,0,0,0,0,0,0,0,0,0,0,0,0,0,0,0,0,0,0,NA,NA,NA,NA
"271","49","1",2,3,3,0,3,3,2,1,3,0,3,3,0,2,0,1,17,15,32,3,6,9.375,18.75,46.875,53.125
"272","49","2",0,0,1,0,1,4,2,0,0,1,4,2,1,2,0,0,10,11,21,0,8,0,38.0952380952381,52.3809523809524,47.6190476190476
"273","49","3",23,2,2,0,2,2,1,0,3,0,2,1,1,1,1,1,35,10,45,24,4,53.3333333333333,8.88888888888889,22.2222222222222,77.7777777777778
"274","49","4",69,8,8,0,8,1,0,0,7,0,1,0,0,0,0,0,96,9,105,69,2,65.7142857142857,1.9047619047619,8.57142857142857,91.4285714285714
"275","49","5",25,10,10,7,12,30,11,2,9,7,32,6,4,9,2,1,108,72,180,26,62,14.4444444444444,34.4444444444444,40,60
"276","49","6",32,10,11,7,9,11,6,6,9,8,10,5,8,4,6,5,94,56,150,37,21,24.6666666666667,14,37.3333333333333,62.6666666666667
"277","5","1",3,4,3,4,3,7,4,3,4,3,7,3,4,3,2,2,31,31,62,5,14,8.06451612903226,22.5806451612903,50,50
"278","5","2",5,0,0,0,1,0,0,0,1,0,1,0,0,1,1,3,9,7,16,8,1,50,6.25,43.75,56.25
"279","5","3",0,0,0,0,0,0,0,0,0,0,0,0,0,0,0,0,0,0,0,0,0,NA,NA,NA,NA
"280","5","4",0,0,0,0,0,0,0,0,0,0,0,0,0,0,0,0,0,0,0,0,0,NA,NA,NA,NA
"281","5","5",0,0,0,0,0,0,0,0,0,0,0,0,0,0,0,0,0,0,0,0,0,NA,NA,NA,NA
"282","5","6",0,0,0,0,0,0,0,0,0,0,0,0,0,0,0,0,1,1,2,0,0,0,0,50,50
"283","50","1",1,1,2,2,2,4,2,3,1,3,5,3,2,3,3,4,19,25,44,5,9,11.3636363636364,20.4545454545455,56.8181818181818,43.1818181818182
"284","50","2",4,5,4,6,5,13,6,5,5,6,13,5,6,5,5,2,50,48,98,6,26,6.12244897959184,26.530612244898,48.9795918367347,51.0204081632653
"285","50","3",1,3,5,2,6,19,5,4,3,4,20,7,1,8,4,7,47,55,102,8,39,7.84313725490196,38.2352941176471,53.921568627451,46.078431372549
"286","50","4",1,4,11,1,12,63,6,1,4,8,63,6,0,7,1,0,100,91,191,1,126,0.523560209424084,65.9685863874346,47.6439790575916,52.3560209424084
"287","50","5",2,11,26,0,25,151,10,5,11,15,150,15,1,14,5,1,231,214,445,3,301,0.674157303370786,67.6404494382023,48.0898876404494,51.9101123595506
"288","50","6",1,14,29,0,28,202,6,4,14,14,201,10,0,10,4,0,285,255,540,1,403,0.185185185185185,74.6296296296296,47.2222222222222,52.7777777777778
"289","51","1",14,9,9,8,8,10,12,3,9,9,9,7,9,6,3,2,75,55,130,16,19,12.3076923076923,14.6153846153846,42.3076923076923,57.6923076923077
"290","51","2",14,5,8,3,8,20,5,2,5,6,20,4,3,5,2,1,66,48,114,15,40,13.1578947368421,35.0877192982456,42.1052631578947,57.8947368421053
"291","51","3",1,5,3,4,4,15,9,2,5,2,16,7,3,8,1,3,43,48,91,4,31,4.3956043956044,34.0659340659341,52.7472527472527,47.2527472527473
"292","51","4",5,3,3,4,6,27,3,2,3,4,31,1,1,4,2,0,55,47,102,5,58,4.90196078431373,56.8627450980392,46.078431372549,53.921568627451
"293","51","5",0,1,1,0,1,12,2,5,1,0,13,7,0,7,5,6,24,40,64,6,25,9.375,39.0625,62.5,37.5
"294","51","6",2,2,2,3,3,11,6,2,2,3,13,5,2,7,2,0,33,35,68,2,24,2.94117647058824,35.2941176470588,51.4705882352941,48.5294117647059
"295","52","1",1,1,1,2,2,1,1,2,1,2,1,1,2,1,2,4,13,15,28,5,2,17.8571428571429,7.14285714285714,53.5714285714286,46.4285714285714
"296","52","2",0,1,0,3,1,0,1,2,0,2,1,0,1,1,2,17,9,26,35,17,1,48.5714285714286,2.85714285714286,74.2857142857143,25.7142857142857
"297","52","3",1,1,3,1,1,4,1,4,1,3,2,4,3,2,5,10,17,32,49,11,6,22.4489795918367,12.2448979591837,65.3061224489796,34.6938775510204
"298","52","4",0,0,0,0,0,0,0,1,0,0,0,1,0,1,2,7,2,13,15,7,0,46.6666666666667,0,86.6666666666667,13.3333333333333
"299","52","5",0,0,0,1,0,1,1,2,0,1,1,2,1,1,2,7,6,17,23,7,2,30.4347826086957,8.69565217391304,73.9130434782609,26.0869565217391
"300","52","6",0,0,0,0,0,2,0,1,0,0,2,1,0,0,0,3,3,9,12,3,4,25,33.3333333333333,75,25
"301","53","1",5,2,4,1,4,4,3,1,3,2,4,3,1,3,1,0,27,17,44,5,8,11.3636363636364,18.1818181818182,38.6363636363636,61.3636363636364
"302","53","2",16,1,1,0,2,1,0,0,2,0,1,0,0,0,0,0,24,3,27,16,2,59.2592592592593,7.40740740740741,11.1111111111111,88.8888888888889
"303","53","3",56,3,3,0,3,0,0,0,3,0,0,0,0,0,0,0,68,3,71,56,0,78.8732394366197,0,4.22535211267606,95.7746478873239
"304","53","4",16,2,2,0,2,1,0,0,2,0,1,0,0,0,0,0,26,3,29,16,2,55.1724137931034,6.89655172413793,10.3448275862069,89.6551724137931
"305","53","5",23,1,1,0,1,0,0,0,1,0,0,0,0,0,0,0,29,1,30,23,0,76.6666666666667,0,3.33333333333333,96.6666666666667
"306","53","6",26,2,2,0,2,0,0,0,2,0,0,0,0,0,0,0,35,2,37,26,0,70.2702702702703,0,5.40540540540541,94.5945945945946
"307","54","1",4,4,4,3,3,3,3,2,4,3,2,2,4,1,2,0,28,19,47,4,5,8.51063829787234,10.6382978723404,40.4255319148936,59.5744680851064
"308","54","2",4,2,2,0,2,0,1,0,2,1,0,0,1,0,0,0,13,5,18,4,0,22.2222222222222,0,27.7777777777778,72.2222222222222
"309","54","3",0,1,0,1,0,0,0,1,0,0,0,0,0,1,1,0,4,4,8,0,0,0,0,50,50
"310","54","4",0,0,0,0,0,0,0,0,0,0,0,0,0,0,0,0,0,0,0,0,0,NA,NA,NA,NA
"311","54","5",0,0,0,0,0,0,0,0,0,0,0,0,0,0,0,0,0,0,0,0,0,NA,NA,NA,NA
"312","54","6",0,0,0,0,0,0,0,0,0,0,0,0,0,0,0,0,0,0,0,0,0,NA,NA,NA,NA
"313","55","1",5,4,8,6,6,14,9,4,4,10,12,7,9,5,4,1,58,53,111,6,26,5.40540540540541,23.4234234234234,47.7477477477477,52.2522522522523
"314","55","2",7,4,6,2,4,6,4,3,5,4,4,5,4,3,3,4,39,32,71,11,10,15.4929577464789,14.0845070422535,45.0704225352113,54.9295774647887
"315","55","3",0,0,0,3,1,2,3,4,0,3,3,3,2,5,4,14,14,36,50,14,5,28,10,72,28
"316","55","4",0,0,0,2,0,0,0,5,0,2,0,3,2,3,5,17,7,35,42,17,0,40.4761904761905,0,83.3333333333333,16.6666666666667
"317","55","5",0,0,0,0,0,0,0,2,0,0,0,2,0,2,2,16,2,25,27,16,0,59.2592592592593,0,92.5925925925926,7.40740740740741
"318","55","6",0,0,0,1,0,0,0,2,0,1,0,1,1,1,2,16,4,24,28,16,0,57.1428571428571,0,85.7142857142857,14.2857142857143
"319","56","1",13,8,8,5,7,8,5,4,8,5,8,4,6,4,5,9,60,50,110,22,16,20,14.5454545454545,45.4545454545455,54.5454545454545
"320","56","2",4,6,5,5,6,10,3,9,6,4,10,7,4,7,9,7,49,56,105,11,20,10.4761904761905,19.047619047619,53.3333333333333,46.6666666666667
"321","56","3",7,6,9,5,8,5,5,7,6,8,4,7,7,6,8,2,54,49,103,9,9,8.7378640776699,8.7378640776699,47.5728155339806,52.4271844660194
"322","56","4",5,4,2,5,4,7,4,6,3,3,10,5,2,8,6,10,39,48,87,15,17,17.2413793103448,19.5402298850575,55.1724137931034,44.8275862068966
"323","56","5",0,3,2,5,3,5,3,5,3,4,6,4,4,5,6,13,27,47,74,13,11,17.5675675675676,14.8648648648649,63.5135135135135,36.4864864864865
"324","56","6",4,3,6,2,3,13,4,7,3,5,10,8,5,6,7,5,43,51,94,9,23,9.57446808510638,24.468085106383,54.2553191489362,45.7446808510638
"325","57","1",0,1,2,1,2,4,2,10,1,1,4,11,0,11,9,21,22,61,83,21,8,25.3012048192771,9.63855421686747,73.4939759036145,26.5060240963855
"326","57","2",0,0,0,2,0,5,0,10,0,2,5,8,2,8,9,56,17,93,110,56,10,50.9090909090909,9.09090909090909,84.5454545454545,15.4545454545455
"327","57","3",0,2,2,3,3,4,4,8,2,3,5,9,2,11,8,18,27,60,87,18,9,20.6896551724138,10.3448275862069,68.9655172413793,31.0344827586207
"328","57","4",1,1,3,3,1,7,3,5,1,5,5,4,5,2,4,4,24,33,57,5,12,8.7719298245614,21.0526315789474,57.8947368421053,42.1052631578947
"329","57","5",0,1,1,4,0,2,2,5,1,4,1,4,4,3,5,17,16,41,57,17,3,29.8245614035088,5.26315789473684,71.9298245614035,28.0701754385965
"330","57","6",1,1,0,1,0,0,1,2,1,0,0,2,1,3,3,19,7,31,38,20,0,52.6315789473684,0,81.5789473684211,18.4210526315789
"331","58","1",6,5,4,9,5,5,5,10,5,7,6,7,7,8,10,14,50,66,116,20,11,17.2413793103448,9.48275862068965,56.8965517241379,43.1034482758621
"332","58","2",0,0,0,1,0,0,3,6,0,1,0,7,1,7,5,92,10,116,126,92,0,73.015873015873,0,92.0634920634921,7.93650793650794
"333","58","3",0,0,0,0,0,0,0,1,0,0,0,1,0,1,1,132,1,138,139,132,0,94.9640287769784,0,99.2805755395683,0.719424460431655
"334","58","4",0,0,0,1,0,0,1,2,0,1,0,2,1,2,2,111,4,122,126,111,0,88.0952380952381,0,96.8253968253968,3.17460317460317
"335","58","5",0,0,0,0,0,0,0,2,0,0,0,2,0,2,2,86,2,95,97,86,0,88.659793814433,0,97.9381443298969,2.06185567010309
"336","58","6",0,0,0,0,0,0,0,3,0,0,0,3,0,3,3,73,3,85,88,73,0,82.9545454545455,0,96.5909090909091,3.40909090909091
"337","59","1",14,8,8,5,9,6,5,2,8,5,7,3,4,3,2,0,58,34,92,14,13,15.2173913043478,14.1304347826087,36.9565217391304,63.0434782608696
"338","59","2",2,2,5,1,4,16,3,0,2,4,15,2,2,1,0,0,35,27,62,2,31,3.2258064516129,50,43.5483870967742,56.4516129032258
"339","59","3",10,7,9,2,10,2,1,1,8,4,3,0,2,1,2,5,45,25,70,15,5,21.4285714285714,7.14285714285714,35.7142857142857,64.2857142857143
"340","59","4",21,6,8,2,8,2,1,1,6,4,2,0,2,0,1,1,51,17,68,22,4,32.3529411764706,5.88235294117647,25,75
"341","59","5",10,6,7,1,6,6,0,2,5,2,5,1,1,0,1,2,38,20,58,12,11,20.6896551724138,18.9655172413793,34.4827586206897,65.5172413793103
"342","59","6",14,3,4,3,7,8,4,0,3,3,11,1,0,4,0,0,45,23,68,14,19,20.5882352941176,27.9411764705882,33.8235294117647,66.1764705882353
"343","6","1",3,4,3,8,5,15,11,6,4,7,18,9,6,12,6,1,57,64,121,4,33,3.30578512396694,27.2727272727273,52.8925619834711,47.1074380165289
"344","6","2",5,5,10,3,9,12,3,6,5,9,11,6,5,5,6,3,55,51,106,8,23,7.54716981132075,21.6981132075472,48.1132075471698,51.8867924528302
"345","6","3",4,6,10,5,10,17,7,3,6,9,18,5,4,6,3,4,64,56,120,8,35,6.66666666666667,29.1666666666667,46.6666666666667,53.3333333333333
"346","6","4",1,2,3,1,2,53,7,2,2,2,51,8,2,7,2,0,72,76,148,1,104,0.675675675675676,70.2702702702703,51.3513513513514,48.6486486486486
"347","6","5",7,7,14,0,14,11,0,0,8,6,11,0,0,0,0,0,56,25,81,7,22,8.64197530864197,27.1604938271605,30.8641975308642,69.1358024691358
"348","6","6",18,8,13,1,13,8,1,0,9,5,8,0,1,0,0,0,65,23,88,18,16,20.4545454545455,18.1818181818182,26.1363636363636,73.8636363636364
"349","60","1",8,2,2,0,1,0,0,0,1,0,0,0,0,0,0,0,15,2,17,8,0,47.0588235294118,0,11.7647058823529,88.2352941176471
"350","60","2",4,1,1,0,1,0,0,0,1,0,0,0,0,0,0,0,10,1,11,4,0,36.3636363636364,0,9.09090909090909,90.9090909090909
"351","60","3",8,0,0,0,0,0,0,0,0,0,0,0,0,0,0,0,11,0,11,8,0,72.7272727272727,0,0,100
"352","60","4",0,1,0,0,1,0,0,0,1,0,0,0,0,0,0,0,4,2,6,0,0,0,0,33.3333333333333,66.6666666666667
"353","60","5",4,1,0,2,1,0,1,1,1,1,0,0,1,0,1,1,11,7,18,5,0,27.7777777777778,0,38.8888888888889,61.1111111111111
"354","60","6",0,0,1,0,0,1,0,1,0,1,0,1,1,0,1,0,5,5,10,0,1,0,10,50,50
"355","61","1",0,1,1,2,2,8,3,2,1,2,8,3,1,3,2,2,20,24,44,2,16,4.54545454545455,36.3636363636364,54.5454545454545,45.4545454545455
"356","61","2",7,2,1,1,1,1,2,0,1,0,1,1,1,1,0,0,17,6,23,7,2,30.4347826086957,8.69565217391304,26.0869565217391,73.9130434782609
"357","61","3",2,0,0,0,0,0,0,1,1,0,0,0,1,0,1,0,6,3,9,2,0,22.2222222222222,0,33.3333333333333,66.6666666666667
"358","61","4",0,0,0,0,0,0,1,0,0,0,0,0,0,0,0,0,2,2,4,0,0,0,0,50,50
"359","61","5",0,0,1,0,0,8,0,0,0,0,7,0,0,0,0,0,10,9,19,0,15,0,78.9473684210526,47.3684210526316,52.6315789473684
"360","61","6",0,0,0,0,0,0,0,0,0,0,0,0,0,0,0,0,1,0,1,0,0,0,0,0,100
"361","62","1",4,7,5,11,3,8,8,8,7,9,6,5,12,4,8,19,55,72,127,23,14,18.1102362204724,11.0236220472441,56.6929133858268,43.3070866141732
"362","62","2",5,7,5,11,10,13,8,7,7,9,17,4,6,9,7,4,67,65,132,9,30,6.81818181818182,22.7272727272727,49.2424242424242,50.7575757575758
"363","62","3",4,4,7,6,10,13,5,6,4,9,15,5,3,8,6,2,56,54,110,6,28,5.45454545454545,25.4545454545455,49.0909090909091,50.9090909090909
"364","62","4",9,4,7,4,7,5,3,7,4,7,5,6,4,5,6,2,46,42,88,11,10,12.5,11.3636363636364,47.7272727272727,52.2727272727273
"365","62","5",8,8,8,4,10,6,2,2,8,4,9,0,1,3,2,0,50,28,78,8,15,10.2564102564103,19.2307692307692,35.8974358974359,64.1025641025641
"366","62","6",0,1,4,4,4,8,6,3,1,7,9,5,4,5,3,3,32,38,70,3,17,4.28571428571429,24.2857142857143,54.2857142857143,45.7142857142857
"367","63","1",1,2,6,2,4,4,3,9,2,6,1,10,4,7,8,12,31,53,84,13,5,15.4761904761905,5.95238095238095,63.0952380952381,36.9047619047619
"368","63","2",0,1,1,1,2,3,1,2,1,1,4,2,0,3,2,8,11,24,35,8,7,22.8571428571429,20,68.5714285714286,31.4285714285714
"369","63","3",0,0,1,0,0,4,2,4,0,1,3,6,1,6,5,45,12,69,81,45,7,55.5555555555556,8.64197530864197,85.1851851851852,14.8148148148148
"370","63","4",6,5,3,6,3,8,3,10,5,4,8,7,6,7,10,13,45,62,107,19,16,17.7570093457944,14.9532710280374,57.9439252336449,42.0560747663551
"371","63","5",2,4,4,7,3,14,8,5,3,7,13,6,7,5,5,17,48,65,113,19,27,16.8141592920354,23.8938053097345,57.5221238938053,42.4778761061947
"372","63","6",0,4,4,5,6,14,4,7,4,5,16,6,2,9,7,5,45,56,101,5,30,4.95049504950495,29.7029702970297,55.4455445544554,44.5544554455446
"373","64","1",0,1,0,0,1,2,0,1,1,0,3,1,0,1,1,3,7,11,18,3,5,16.6666666666667,27.7777777777778,61.1111111111111,38.8888888888889
"374","64","2",8,2,2,0,2,0,1,0,3,0,0,0,1,0,0,0,18,4,22,8,0,36.3636363636364,0,18.1818181818182,81.8181818181818
"375","64","3",6,1,0,1,0,0,1,0,1,0,0,0,1,0,0,0,12,2,14,6,0,42.8571428571429,0,14.2857142857143,85.7142857142857
"376","64","4",5,1,2,0,2,2,2,0,2,1,1,2,1,1,0,0,17,8,25,5,3,20,12,32,68
"377","64","5",0,0,0,2,1,1,2,2,0,1,2,2,1,3,2,2,10,14,24,2,3,8.33333333333333,12.5,58.3333333333333,41.6666666666667
"378","64","6",0,0,0,0,0,1,1,4,0,0,1,5,0,4,4,9,7,25,32,9,2,28.125,6.25,78.125,21.875
"379","65","1",0,1,3,0,3,12,1,1,1,3,12,1,1,1,1,0,23,21,44,0,24,0,54.5454545454545,47.7272727272727,52.2727272727273
"380","65","2",0,0,0,0,0,0,0,0,0,0,0,0,0,0,0,0,0,0,0,0,0,NA,NA,NA,NA
"381","65","3",0,0,0,0,0,0,0,0,0,0,1,0,0,0,0,0,2,2,4,0,1,0,25,50,50
"382","65","4",0,0,0,0,0,0,0,0,0,0,0,0,0,0,0,0,0,0,0,0,0,NA,NA,NA,NA
"383","65","5",0,0,0,0,0,0,0,0,0,0,0,0,0,0,0,0,1,2,3,0,0,0,0,66.6666666666667,33.3333333333333
"384","65","6",0,0,0,0,0,0,0,0,0,0,0,0,0,0,0,0,0,0,0,0,0,NA,NA,NA,NA
"385","66","1",0,1,5,3,6,1,3,3,1,7,2,2,3,3,3,3,24,25,49,3,3,6.12244897959184,6.12244897959184,51.0204081632653,48.9795918367347
"386","66","2",0,0,2,3,2,3,5,2,0,5,2,4,3,4,2,2,18,24,42,2,5,4.76190476190476,11.9047619047619,57.1428571428571,42.8571428571429
"387","66","3",2,1,2,3,2,6,4,6,1,4,7,7,3,7,6,12,28,48,76,14,13,18.4210526315789,17.1052631578947,63.1578947368421,36.8421052631579
"388","66","4",2,1,5,5,5,3,3,7,1,9,3,5,5,5,7,18,32,55,87,20,6,22.9885057471264,6.89655172413793,63.2183908045977,36.7816091954023
"389","66","5",6,4,8,3,7,13,3,6,4,7,12,7,4,6,6,6,51,54,105,12,25,11.4285714285714,23.8095238095238,51.4285714285714,48.5714285714286
"390","66","6",4,6,8,7,8,14,5,6,6,9,14,3,7,3,5,12,58,62,120,16,28,13.3333333333333,23.3333333333333,51.6666666666667,48.3333333333333
"391","67","1",0,0,1,0,1,3,2,1,1,1,3,2,1,2,1,1,11,12,23,1,6,4.34782608695652,26.0869565217391,52.1739130434783,47.8260869565217
"392","67","2",0,1,1,0,1,1,1,0,1,1,1,1,1,0,0,0,7,6,13,0,2,0,15.3846153846154,46.1538461538462,53.8461538461538
"393","67","3",0,0,0,0,0,0,0,0,0,0,0,0,0,0,0,0,0,0,0,0,0,NA,NA,NA,NA
"394","67","4",0,1,1,0,0,1,0,0,1,0,0,1,0,0,0,0,4,4,8,0,1,0,12.5,50,50
"395","67","5",0,0,0,0,0,0,1,0,0,0,1,1,0,2,1,0,3,6,9,0,1,0,11.1111111111111,66.6666666666667,33.3333333333333
"396","67","6",0,0,0,0,0,0,0,0,1,0,0,0,1,0,0,0,3,2,5,0,0,0,0,40,60
"397","68","1",0,1,1,0,0,2,0,1,1,0,1,2,0,1,1,1,6,9,15,1,3,6.66666666666667,20,60,40
"398","68","2",0,1,2,2,3,4,1,5,1,3,5,4,1,5,5,25,19,51,70,25,9,35.7142857142857,12.8571428571429,72.8571428571429,27.1428571428571
"399","68","3",5,6,8,3,7,8,5,4,7,5,7,6,5,5,5,6,49,46,95,11,15,11.5789473684211,15.7894736842105,48.4210526315789,51.5789473684211
"400","68","4",6,6,2,4,4,4,5,8,6,1,5,9,3,10,8,15,41,58,99,21,9,21.2121212121212,9.09090909090909,58.5858585858586,41.4141414141414
"401","68","5",6,9,8,7,7,5,5,6,9,6,4,3,8,2,6,3,54,43,97,9,9,9.27835051546392,9.27835051546392,44.3298969072165,55.6701030927835
"402","68","6",2,3,4,9,4,8,8,6,3,10,8,5,9,5,7,7,45,56,101,9,16,8.91089108910891,15.8415841584158,55.4455445544554,44.5544554455446
"403","69","1",17,4,9,2,10,11,3,2,5,7,12,3,2,4,2,2,61,37,98,19,23,19.3877551020408,23.469387755102,37.7551020408163,62.2448979591837
"404","69","2",6,6,5,6,6,12,9,1,6,5,14,4,5,5,1,0,53,41,94,6,26,6.38297872340426,27.6595744680851,43.6170212765957,56.3829787234043
"405","69","3",1,2,1,3,1,3,8,8,2,2,3,13,3,14,8,8,28,55,83,9,6,10.8433734939759,7.2289156626506,66.2650602409639,33.7349397590361
"406","69","4",2,3,1,3,1,8,5,6,3,1,8,9,3,8,6,5,30,45,75,7,16,9.33333333333333,21.3333333333333,60,40
"407","69","5",0,0,2,3,3,21,4,6,0,5,22,7,3,7,6,5,41,56,97,5,43,5.15463917525773,44.3298969072165,57.7319587628866,42.2680412371134
"408","69","6",1,1,0,1,0,4,2,0,1,0,4,2,1,1,0,0,10,11,21,1,8,4.76190476190476,38.0952380952381,52.3809523809524,47.6190476190476
"409","7","1",13,9,7,6,7,6,7,6,8,4,6,7,5,7,5,10,61,55,116,23,12,19.8275862068966,10.3448275862069,47.4137931034483,52.5862068965517
"410","7","2",21,10,8,11,11,13,12,4,10,9,15,5,9,7,4,6,92,66,158,27,28,17.0886075949367,17.7215189873418,41.7721518987342,58.2278481012658
"411","7","3",8,6,6,8,4,12,6,8,6,8,11,6,10,5,9,19,60,75,135,27,23,20,17.037037037037,55.5555555555556,44.4444444444444
"412","7","4",26,11,10,3,8,12,3,3,11,2,10,3,5,1,3,1,79,36,115,27,22,23.4782608695652,19.1304347826087,31.304347826087,68.695652173913
"413","7","5",14,6,6,5,8,12,4,3,6,5,13,3,3,4,3,3,59,42,101,17,25,16.8316831683168,24.7524752475248,41.5841584158416,58.4158415841584
"414","7","6",15,7,7,3,7,12,5,1,7,3,12,3,3,4,1,1,58,36,94,16,24,17.0212765957447,25.531914893617,38.2978723404255,61.7021276595745
"415","70","1",6,2,5,1,5,5,4,2,3,4,5,4,2,4,2,0,33,24,57,6,10,10.5263157894737,17.5438596491228,42.1052631578947,57.8947368421053
"416","70","2",12,9,12,2,10,12,5,2,9,5,10,5,4,3,2,1,66,40,106,13,22,12.2641509433962,20.7547169811321,37.7358490566038,62.2641509433962
"417","70","3",62,11,10,1,10,1,1,0,10,0,1,0,1,0,0,0,98,13,111,62,2,55.8558558558559,1.8018018018018,11.7117117117117,88.2882882882883
"418","70","4",73,7,6,0,5,1,1,0,6,0,0,1,1,0,0,0,95,9,104,73,1,70.1923076923077,0.961538461538462,8.65384615384615,91.3461538461538
"419","70","5",85,4,4,0,4,5,1,0,3,0,5,1,0,1,0,0,105,11,116,85,10,73.2758620689655,8.62068965517241,9.48275862068965,90.5172413793103
"420","70","6",44,9,10,0,9,5,1,0,9,1,4,1,1,0,0,0,81,16,97,44,9,45.360824742268,9.27835051546392,16.4948453608247,83.5051546391753
"421","71","1",19,5,6,4,7,8,5,4,5,5,9,6,2,7,4,9,59,49,108,28,17,25.9259259259259,15.7407407407407,45.3703703703704,54.6296296296296
"422","71","2",3,10,13,6,14,10,6,9,10,8,11,9,5,10,9,10,73,73,146,13,21,8.9041095890411,14.3835616438356,50,50
"423","71","3",2,12,14,9,19,80,9,4,12,12,85,4,4,9,4,0,151,131,282,2,165,0.709219858156028,58.5106382978723,46.4539007092199,53.5460992907801
"424","71","4",5,9,11,9,14,48,14,9,9,10,51,15,5,18,9,3,120,122,242,8,99,3.30578512396694,40.9090909090909,50.4132231404959,49.5867768595041
"425","71","5",2,5,10,3,10,42,3,4,5,7,42,4,2,5,4,2,80,73,153,4,84,2.61437908496732,54.9019607843137,47.7124183006536,52.2875816993464
"426","71","6",2,4,8,2,9,38,4,0,4,6,38,2,1,2,0,0,68,55,123,2,76,1.6260162601626,61.7886178861789,44.7154471544715,55.2845528455285
"427","72","1",0,0,0,0,0,1,1,0,0,0,2,1,0,2,0,0,4,6,10,0,3,0,30,60,40
"428","72","2",0,0,0,0,0,0,0,0,0,0,0,0,0,0,0,0,1,1,2,0,0,0,0,50,50
"429","72","3",0,0,0,0,0,0,0,0,0,0,0,0,0,0,0,0,1,2,3,0,0,0,0,66.6666666666667,33.3333333333333
"430","72","4",0,0,0,0,0,0,0,0,0,0,0,0,0,0,0,0,0,0,0,0,0,NA,NA,NA,NA
"431","72","5",0,0,0,0,0,0,0,0,0,0,0,0,0,0,0,0,1,1,2,0,0,0,0,50,50
"432","72","6",0,0,0,0,0,0,0,0,0,0,0,0,0,0,0,0,0,0,0,0,0,NA,NA,NA,NA
"433","73","1",7,8,13,4,8,12,9,6,8,8,7,11,8,7,6,3,68,60,128,10,19,7.8125,14.84375,46.875,53.125
"434","73","2",2,4,8,4,6,16,8,4,4,9,14,7,7,5,4,2,54,53,107,4,30,3.73831775700935,28.0373831775701,49.5327102803738,50.4672897196262
"435","73","3",7,6,6,4,7,7,4,2,5,4,8,3,2,4,2,3,44,33,77,10,15,12.987012987013,19.4805194805195,42.8571428571429,57.1428571428571
"436","73","4",0,3,3,3,4,2,0,4,3,3,3,1,2,2,4,4,21,23,44,4,5,9.09090909090909,11.3636363636364,52.2727272727273,47.7272727272727
"437","73","5",14,2,1,2,1,0,4,0,3,1,0,1,3,1,0,0,27,9,36,14,0,38.8888888888889,0,25,75
"438","73","6",11,2,2,1,2,1,1,1,3,1,1,0,2,0,1,0,24,8,32,11,2,34.375,6.25,25,75
"439","74","1",3,3,2,2,2,4,2,5,3,1,3,5,2,5,5,8,24,34,58,11,7,18.9655172413793,12.0689655172414,58.6206896551724,41.3793103448276
"440","74","2",3,5,7,3,7,9,5,3,5,5,9,5,3,5,3,1,44,37,81,4,18,4.93827160493827,22.2222222222222,45.679012345679,54.320987654321
"441","74","3",10,9,3,11,5,0,6,6,8,5,2,1,8,3,5,7,50,42,92,17,2,18.4782608695652,2.17391304347826,45.6521739130435,54.3478260869565
"442","74","4",4,5,9,5,8,4,4,4,6,9,3,3,7,2,4,0,46,34,80,4,7,5,8.75,42.5,57.5
"443","74","5",3,6,7,2,7,8,2,2,7,3,7,2,3,1,2,1,40,26,66,4,15,6.06060606060606,22.7272727272727,39.3939393939394,60.6060606060606
"444","74","6",11,4,7,1,4,7,5,4,3,4,4,8,3,5,4,2,44,35,79,13,11,16.4556962025316,13.9240506329114,44.3037974683544,55.6962025316456
"445","75","1",0,0,2,0,1,2,2,2,0,2,1,3,1,2,1,1,9,14,23,1,3,4.34782608695652,13.0434782608696,60.8695652173913,39.1304347826087
"446","75","2",3,4,3,3,3,6,3,4,5,2,6,4,4,3,4,3,32,31,63,6,12,9.52380952380952,19.047619047619,49.2063492063492,50.7936507936508
"447","75","3",7,6,4,7,4,4,7,4,5,5,4,4,6,4,4,5,44,39,83,12,8,14.4578313253012,9.63855421686747,46.9879518072289,53.0120481927711
"448","75","4",13,5,6,1,6,7,2,0,5,2,7,1,1,0,0,0,41,18,59,13,14,22.0338983050847,23.728813559322,30.5084745762712,69.4915254237288
"449","75","5",17,4,5,1,4,6,2,1,4,2,5,3,2,2,2,0,41,22,63,17,11,26.984126984127,17.4603174603175,34.9206349206349,65.0793650793651
"450","75","6",3,5,5,3,5,5,5,0,5,3,5,2,2,3,0,0,32,22,54,3,10,5.55555555555556,18.5185185185185,40.7407407407407,59.2592592592593
"451","76","1",50,11,11,6,11,9,8,1,12,6,9,3,6,3,1,0,110,40,150,50,18,33.3333333333333,12,26.6666666666667,73.3333333333333
"452","76","2",91,10,8,2,8,0,2,0,10,0,0,0,2,0,0,0,124,12,136,91,0,66.9117647058823,0,8.82352941176471,91.1764705882353
"453","76","3",75,12,11,1,11,1,1,0,12,0,1,0,1,0,0,0,115,14,129,75,2,58.1395348837209,1.55038759689922,10.8527131782946,89.1472868217054
"454","76","4",84,8,7,1,7,0,0,1,8,0,0,0,1,0,1,0,111,10,121,84,0,69.4214876033058,0,8.26446280991735,91.7355371900826
"455","76","5",65,5,4,2,5,3,2,1,6,1,4,1,1,2,1,0,90,16,106,65,7,61.3207547169811,6.60377358490566,15.0943396226415,84.9056603773585
"456","76","6",70,4,6,0,6,1,0,0,4,2,1,0,0,0,0,0,90,7,97,70,2,72.1649484536082,2.06185567010309,7.21649484536082,92.7835051546392
"457","77","1",3,5,4,5,6,2,2,7,4,4,4,4,2,6,6,12,34,45,79,15,6,18.9873417721519,7.59493670886076,56.9620253164557,43.0379746835443
"458","77","2",4,4,4,6,5,9,6,7,4,6,10,7,5,8,8,12,46,62,108,16,19,14.8148148148148,17.5925925925926,57.4074074074074,42.5925925925926
"459","77","3",28,7,11,5,8,7,7,3,8,9,4,5,8,2,3,4,79,43,122,32,11,26.2295081967213,9.01639344262295,35.2459016393443,64.7540983606557
"460","77","4",15,10,10,4,8,14,6,5,10,4,12,7,6,5,5,2,75,51,126,17,26,13.4920634920635,20.6349206349206,40.4761904761905,59.5238095238095
"461","77","5",1,1,3,3,1,3,3,8,1,5,1,8,4,6,8,18,24,53,77,19,4,24.6753246753247,5.19480519480519,68.8311688311688,31.1688311688312
"462","77","6",0,0,0,1,1,1,3,3,0,1,3,5,0,6,3,2,11,21,32,2,4,6.25,12.5,65.625,34.375
"463","78","1",11,5,9,6,8,8,7,7,5,10,7,8,7,8,8,9,62,64,126,20,15,15.8730158730159,11.9047619047619,50.7936507936508,49.2063492063492
"464","78","2",9,9,10,3,7,13,4,4,9,3,10,5,5,3,4,7,60,48,108,16,23,14.8148148148148,21.2962962962963,44.4444444444444,55.5555555555556
"465","78","3",1,5,9,6,7,9,7,6,5,10,8,6,8,5,6,8,52,57,109,9,17,8.25688073394495,15.5963302752294,52.2935779816514,47.7064220183486
"466","78","4",4,6,4,6,4,7,8,7,6,4,8,9,6,9,7,3,48,53,101,7,15,6.93069306930693,14.8514851485149,52.4752475247525,47.5247524752475
"467","78","5",1,3,4,2,5,3,3,6,4,3,4,7,2,8,6,13,30,47,77,14,7,18.1818181818182,9.09090909090909,61.038961038961,38.961038961039
"468","78","6",0,1,4,2,5,9,5,0,1,5,10,3,2,3,0,0,28,25,53,0,19,0,35.8490566037736,47.1698113207547,52.8301886792453
"469","79","1",30,9,10,3,9,5,3,1,10,3,4,1,4,0,1,0,73,23,96,30,9,31.25,9.375,23.9583333333333,76.0416666666667
"470","79","2",51,8,8,1,7,4,3,0,8,1,3,2,2,1,0,0,85,17,102,51,7,50,6.86274509803922,16.6666666666667,83.3333333333333
"471","79","3",85,2,3,0,2,1,0,1,2,1,0,1,1,0,1,0,97,6,103,85,1,82.5242718446602,0.970873786407767,5.8252427184466,94.1747572815534
"472","79","4",70,6,4,2,4,3,2,2,5,0,3,2,1,2,1,1,93,18,111,71,6,63.963963963964,5.40540540540541,16.2162162162162,83.7837837837838
"473","79","5",36,8,8,2,9,5,3,0,9,2,5,1,2,1,0,0,74,20,94,36,10,38.2978723404255,10.6382978723404,21.2765957446809,78.7234042553192
"474","79","6",37,7,5,1,5,5,1,0,6,0,5,0,1,0,0,0,63,13,76,37,10,48.6842105263158,13.1578947368421,17.1052631578947,82.8947368421053
"475","8","1",2,3,2,3,4,1,1,2,3,2,3,0,1,2,2,3,20,17,37,5,4,13.5135135135135,10.8108108108108,45.9459459459459,54.0540540540541
"476","8","2",26,5,6,1,6,3,0,1,5,2,3,0,1,1,2,12,49,28,77,38,6,49.3506493506493,7.79220779220779,36.3636363636364,63.6363636363636
"477","8","3",3,5,5,5,5,9,2,8,5,5,9,5,6,5,8,12,44,56,100,15,18,15,18,56,44
"478","8","4",7,7,6,8,8,3,3,7,7,7,6,2,6,4,7,8,51,48,99,15,9,15.1515151515152,9.09090909090909,48.4848484848485,51.5151515151515
"479","8","5",20,5,10,2,10,10,5,2,5,7,10,5,2,5,2,0,65,38,103,20,20,19.4174757281553,19.4174757281553,36.8932038834951,63.1067961165049
"480","8","6",3,6,7,3,8,14,3,4,6,4,14,4,3,4,4,2,50,42,92,5,28,5.43478260869565,30.4347826086957,45.6521739130435,54.3478260869565
"481","80","1",19,3,5,3,5,4,4,1,3,5,4,2,3,2,1,0,47,20,67,19,8,28.3582089552239,11.9402985074627,29.8507462686567,70.1492537313433
"482","80","2",41,12,11,5,7,11,5,3,11,4,7,4,8,0,3,0,96,39,135,41,18,30.3703703703704,13.3333333333333,28.8888888888889,71.1111111111111
"483","80","3",6,5,7,1,7,6,1,3,5,3,6,3,2,3,4,8,38,35,73,14,12,19.1780821917808,16.4383561643836,47.9452054794521,52.0547945205479
"484","80","4",0,1,2,0,2,2,0,0,1,1,2,0,0,0,0,0,8,6,14,0,4,0,28.5714285714286,42.8571428571429,57.1428571428571
"485","80","5",7,3,4,0,5,3,0,0,4,1,3,0,0,0,0,0,25,8,33,7,6,21.2121212121212,18.1818181818182,24.2424242424242,75.7575757575758
"486","80","6",10,1,2,0,1,0,0,0,0,1,0,0,0,0,0,0,16,2,18,10,0,55.5555555555556,0,11.1111111111111,88.8888888888889
"487","81","1",0,3,6,5,4,11,8,5,3,8,8,8,7,5,4,10,42,56,98,10,19,10.2040816326531,19.3877551020408,57.1428571428571,42.8571428571429
"488","81","2",10,5,4,5,4,4,2,5,4,4,4,3,4,3,5,6,40,35,75,16,8,21.3333333333333,10.6666666666667,46.6666666666667,53.3333333333333
"489","81","3",0,2,1,1,2,2,1,5,2,1,3,5,0,6,5,4,16,27,43,4,5,9.30232558139535,11.6279069767442,62.7906976744186,37.2093023255814
"490","81","4",0,0,0,0,0,0,2,5,0,0,0,7,0,7,5,2,8,23,31,2,0,6.45161290322581,0,74.1935483870968,25.8064516129032
"491","81","5",0,0,0,1,0,1,1,2,0,1,1,2,1,2,2,11,6,22,28,11,2,39.2857142857143,7.14285714285714,78.5714285714286,21.4285714285714
"492","81","6",0,0,0,2,2,0,1,2,0,2,2,1,0,4,3,8,8,22,30,8,2,26.6666666666667,6.66666666666667,73.3333333333333,26.6666666666667
"493","82","1",2,4,6,6,8,6,3,5,3,8,9,2,3,5,5,10,42,46,88,12,15,13.6363636363636,17.0454545454545,52.2727272727273,47.7272727272727
"494","82","2",0,4,6,4,5,13,5,6,4,5,12,7,4,7,6,5,44,52,96,5,25,5.20833333333333,26.0416666666667,54.1666666666667,45.8333333333333
"495","82","3",2,2,2,3,3,5,3,4,2,3,6,4,2,5,4,4,25,32,57,6,11,10.5263157894737,19.2982456140351,56.140350877193,43.859649122807
"496","82","4",5,10,9,8,11,13,13,5,10,7,15,10,6,12,5,0,75,67,142,5,28,3.52112676056338,19.7183098591549,47.1830985915493,52.8169014084507
"497","82","5",3,6,6,5,6,9,4,6,6,5,10,5,5,5,6,8,47,51,98,11,19,11.2244897959184,19.3877551020408,52.0408163265306,47.9591836734694
"498","82","6",3,4,7,5,10,50,5,5,4,8,54,5,2,8,5,3,91,90,181,6,104,3.31491712707182,57.4585635359116,49.7237569060773,50.2762430939227
"499","83","1",1,1,1,0,2,2,0,0,1,0,3,0,0,0,0,0,9,5,14,1,5,7.14285714285714,35.7142857142857,35.7142857142857,64.2857142857143
"500","83","2",0,0,0,0,0,0,0,0,0,0,0,0,0,0,0,0,0,2,2,0,0,0,0,100,0
"501","83","3",0,0,0,0,0,0,0,0,0,0,0,0,0,0,0,0,0,0,0,0,0,NA,NA,NA,NA
"502","83","4",0,0,0,0,0,0,1,0,0,0,0,1,1,0,0,0,3,3,6,0,0,0,0,50,50
"503","83","5",0,0,0,0,0,0,0,0,0,0,0,0,0,0,0,0,0,0,0,0,0,NA,NA,NA,NA
"504","83","6",0,0,0,0,0,0,1,1,0,0,0,2,0,1,0,0,2,6,8,0,0,0,0,75,25
"505","84","1",0,0,1,2,1,2,3,2,0,2,2,3,1,4,2,2,12,18,30,2,4,6.66666666666667,13.3333333333333,60,40
"506","84","2",0,0,0,0,0,0,0,0,0,0,0,1,0,0,0,0,1,3,4,0,0,0,0,75,25
"507","84","3",0,0,0,0,0,0,0,0,0,0,0,0,0,0,0,0,0,0,0,0,0,NA,NA,NA,NA
"508","84","4",0,0,0,0,0,0,0,0,0,0,0,0,0,0,0,0,0,0,0,0,0,NA,NA,NA,NA
"509","84","5",0,0,0,0,0,0,0,0,0,0,0,0,0,0,0,0,0,0,0,0,0,NA,NA,NA,NA
"510","84","6",0,0,0,0,0,0,0,0,0,0,0,0,0,0,0,0,0,0,0,0,0,NA,NA,NA,NA
"511","85","1",28,9,9,7,11,19,8,3,9,7,21,4,5,6,3,1,96,57,153,29,40,18.9542483660131,26.1437908496732,37.2549019607843,62.7450980392157
"512","85","2",72,8,10,0,10,6,0,0,8,2,6,0,0,0,0,0,109,16,125,72,12,57.6,9.6,12.8,87.2
"513","85","3",63,6,5,2,7,2,2,0,5,1,4,0,0,2,0,0,89,13,102,63,6,61.7647058823529,5.88235294117647,12.7450980392157,87.2549019607843
"514","85","4",16,5,6,0,5,3,1,0,4,1,2,1,1,0,0,0,38,10,48,16,5,33.3333333333333,10.4166666666667,20.8333333333333,79.1666666666667
"515","85","5",15,3,4,1,5,1,1,0,4,2,1,0,1,0,0,0,33,8,41,15,2,36.5853658536585,4.8780487804878,19.5121951219512,80.4878048780488
"516","85","6",14,4,4,0,4,0,0,0,4,0,0,0,0,0,0,0,29,4,33,14,0,42.4242424242424,0,12.1212121212121,87.8787878787879
"517","86","1",4,2,3,0,1,4,2,4,1,1,2,7,1,5,4,7,21,30,51,11,6,21.5686274509804,11.7647058823529,58.8235294117647,41.1764705882353
"518","86","2",0,0,0,0,0,0,0,1,0,0,0,1,0,0,1,0,2,4,6,0,0,0,0,66.6666666666667,33.3333333333333
"519","86","3",0,0,0,0,0,0,0,0,0,0,0,0,0,0,0,0,0,0,0,0,0,NA,NA,NA,NA
"520","86","4",0,0,0,0,0,0,0,0,0,0,0,0,0,0,0,0,1,1,2,0,0,0,0,50,50
"521","86","5",0,0,0,0,0,2,0,0,0,0,1,0,0,0,0,0,3,3,6,0,3,0,50,50,50
"522","86","6",0,0,0,0,0,0,0,0,0,0,0,0,0,0,0,0,0,0,0,0,0,NA,NA,NA,NA
"523","87","1",1,2,2,0,2,2,0,1,2,1,2,1,1,1,1,0,12,10,22,1,4,4.54545454545455,18.1818181818182,45.4545454545455,54.5454545454545
"524","87","2",30,4,4,1,4,1,0,1,4,1,1,0,1,0,1,0,48,8,56,30,2,53.5714285714286,3.57142857142857,14.2857142857143,85.7142857142857
"525","87","3",57,3,4,0,4,3,0,0,3,1,3,0,0,0,0,0,74,7,81,57,6,70.3703703703704,7.40740740740741,8.64197530864197,91.358024691358
"526","87","4",25,4,5,0,4,1,0,0,3,1,1,0,0,0,0,0,41,6,47,25,2,53.1914893617021,4.25531914893617,12.7659574468085,87.2340425531915
"527","87","5",15,7,6,3,7,11,3,0,8,2,12,0,2,1,0,0,55,25,80,15,23,18.75,28.75,31.25,68.75
"528","87","6",4,10,19,1,15,133,8,4,10,10,129,11,4,8,4,0,195,178,373,4,262,1.07238605898123,70.2412868632708,47.7211796246649,52.2788203753351
"529","88","1",0,1,3,1,3,5,5,9,1,3,5,13,1,12,8,16,27,62,89,16,10,17.9775280898876,11.2359550561798,69.6629213483146,30.3370786516854
"530","88","2",5,6,6,5,8,4,7,3,7,5,6,5,4,6,3,3,47,39,86,8,10,9.30232558139535,11.6279069767442,45.3488372093023,54.6511627906977
"531","88","3",5,5,3,5,6,1,5,1,5,3,4,1,2,5,2,1,32,25,57,6,5,10.5263157894737,8.7719298245614,43.859649122807,56.140350877193
"532","88","4",9,7,7,2,9,4,1,3,7,2,6,2,0,4,3,3,42,30,72,12,10,16.6666666666667,13.8888888888889,41.6666666666667,58.3333333333333
"533","88","5",9,7,9,1,11,3,1,0,7,4,4,0,0,1,0,0,43,17,60,9,7,15,11.6666666666667,28.3333333333333,71.6666666666667
"534","88","6",12,7,6,1,6,3,1,1,7,0,3,1,1,1,1,0,40,14,54,12,6,22.2222222222222,11.1111111111111,25.9259259259259,74.0740740740741
"535","89","1",0,0,0,1,0,1,1,2,0,0,1,2,0,2,1,32,5,41,46,32,2,69.5652173913043,4.34782608695652,89.1304347826087,10.8695652173913
"536","89","2",0,0,0,0,0,0,0,2,0,0,0,3,0,3,3,65,3,76,79,65,0,82.2784810126582,0,96.2025316455696,3.79746835443038
"537","89","3",0,0,0,0,0,0,0,1,0,0,0,1,0,1,1,45,1,51,52,45,0,86.5384615384615,0,98.0769230769231,1.92307692307692
"538","89","4",0,0,0,0,0,0,0,0,0,0,0,0,0,0,0,54,0,57,57,54,0,94.7368421052632,0,100,0
"539","89","5",0,0,0,0,0,0,0,0,0,0,0,0,0,0,0,18,0,21,21,18,0,85.7142857142857,0,100,0
"540","89","6",0,0,0,0,0,0,0,1,0,0,0,1,0,1,1,50,1,56,57,50,0,87.719298245614,0,98.2456140350877,1.75438596491228
"541","9","1",0,1,1,2,2,4,0,6,1,2,4,4,1,4,5,19,16,43,59,19,8,32.2033898305085,13.5593220338983,72.8813559322034,27.1186440677966
"542","9","2",0,0,0,0,0,0,0,2,0,0,0,2,0,2,2,102,2,111,113,102,0,90.2654867256637,0,98.2300884955752,1.76991150442478
"543","9","3",0,0,0,0,0,0,0,4,0,0,0,4,0,4,4,104,4,119,123,104,0,84.5528455284553,0,96.7479674796748,3.2520325203252
"544","9","4",0,0,0,0,0,0,0,5,0,0,0,5,0,6,6,96,6,115,121,96,0,79.3388429752066,0,95.0413223140496,4.95867768595041
"545","9","5",0,0,0,1,0,1,0,5,0,1,1,4,1,4,5,76,7,95,102,76,2,74.5098039215686,1.96078431372549,93.1372549019608,6.86274509803922
"546","9","6",0,1,0,1,1,1,0,8,1,0,2,7,0,9,9,57,13,87,100,57,3,57,3,87,13
"547","90","1",10,6,6,1,3,4,2,2,6,1,1,4,4,1,2,0,35,21,56,10,5,17.8571428571429,8.92857142857143,37.5,62.5
"548","90","2",2,2,4,2,2,5,5,6,2,4,3,8,4,6,5,19,28,54,82,21,8,25.609756097561,9.75609756097561,65.8536585365854,34.1463414634146
"549","90","3",5,6,9,2,10,15,4,5,6,5,17,7,1,8,5,5,58,55,113,10,32,8.84955752212389,28.3185840707965,48.6725663716814,51.3274336283186
"550","90","4",24,9,7,7,7,5,7,5,9,5,5,5,7,5,5,2,74,43,117,26,10,22.2222222222222,8.54700854700855,36.7521367521367,63.2478632478633
"551","90","5",33,13,14,4,13,7,5,0,12,5,7,1,4,1,0,0,91,31,122,33,14,27.0491803278689,11.4754098360656,25.4098360655738,74.5901639344262
"552","90","6",14,6,7,5,5,9,9,3,6,6,6,7,7,4,2,2,58,43,101,16,15,15.8415841584158,14.8514851485149,42.5742574257426,57.4257425742574
"553","91","1",11,6,7,3,7,18,5,2,6,4,18,3,3,4,2,3,60,45,105,14,36,13.3333333333333,34.2857142857143,42.8571428571429,57.1428571428571
"554","91","2",2,4,5,1,5,6,3,2,4,3,6,4,2,3,2,3,30,28,58,5,12,8.62068965517241,20.6896551724138,48.2758620689655,51.7241379310345
"555","91","3",0,1,3,1,3,13,2,1,1,3,13,2,1,2,1,2,25,27,52,2,26,3.84615384615385,50,51.9230769230769,48.0769230769231
"556","91","4",17,4,4,1,6,9,1,0,5,1,10,0,0,1,0,0,45,17,62,17,19,27.4193548387097,30.6451612903226,27.4193548387097,72.5806451612903
"557","91","5",13,2,2,0,2,1,1,0,2,0,1,1,0,1,0,0,24,5,29,13,2,44.8275862068966,6.89655172413793,17.2413793103448,82.7586206896552
"558","91","6",10,3,2,1,3,3,1,0,2,0,4,0,0,1,0,0,25,8,33,10,7,30.3030303030303,21.2121212121212,24.2424242424242,75.7575757575758
"559","92","1",0,0,0,0,0,3156,0,0,0,0,3157,0,0,0,0,0,3158,3158,6316,0,6313,0,99.9525015832806,50,50
"560","92","2",0,0,0,0,0,3959,0,0,0,0,3959,0,0,0,0,0,3960,3961,7921,0,7918,0,99.9621259941926,50.0063123343012,49.9936876656988
"561","92","3",0,0,0,0,0,3934,0,0,0,0,3934,0,0,0,0,0,3936,3935,7871,0,7868,0,99.961885402109,49.9936475670182,50.0063524329818
"562","92","4",0,0,0,0,0,2920,0,0,0,0,2921,0,0,0,0,0,2922,2922,5844,0,5841,0,99.9486652977413,50,50
"563","92","5",0,0,0,0,0,2163,0,0,0,0,2163,0,0,0,0,0,2164,2165,4329,0,4326,0,99.9306999306999,50.01155001155,49.98844998845
"564","92","6",0,0,0,0,0,3463,0,0,0,0,3463,0,0,0,0,0,3465,3464,6929,0,6926,0,99.9567037090489,49.9927839515082,50.0072160484918
"565","93","1",2,3,2,2,3,5,3,1,3,1,7,2,1,4,1,2,23,22,45,4,12,8.88888888888889,26.6666666666667,48.8888888888889,51.1111111111111
"566","93","2",3,3,2,2,4,7,1,2,3,1,9,1,0,2,1,2,24,22,46,5,16,10.8695652173913,34.7826086956522,47.8260869565217,52.1739130434783
"567","93","3",0,0,1,1,1,6,1,7,0,2,5,7,1,6,7,17,18,47,65,17,11,26.1538461538462,16.9230769230769,72.3076923076923,27.6923076923077
"568","93","4",0,0,1,0,0,29,1,5,0,1,28,6,1,4,4,7,36,54,90,7,57,7.77777777777778,63.3333333333333,60,40
"569","93","5",0,0,0,0,0,0,1,5,0,0,0,6,0,6,5,40,7,59,66,40,0,60.6060606060606,0,89.3939393939394,10.6060606060606
"570","93","6",0,0,1,4,3,2,3,5,1,5,4,3,3,5,5,21,21,47,68,21,6,30.8823529411765,8.82352941176471,69.1176470588235,30.8823529411765
"571","94","1",55,11,13,1,13,3,2,1,11,3,3,2,1,2,1,0,102,23,125,55,6,44,4.8,18.4,81.6
"572","94","2",36,5,6,1,8,3,1,0,6,2,4,0,0,1,0,0,63,13,76,36,7,47.3684210526316,9.21052631578947,17.1052631578947,82.8947368421053
"573","94","3",16,7,7,2,6,8,3,0,6,2,7,1,2,1,0,0,50,21,71,16,15,22.5352112676056,21.1267605633803,29.5774647887324,70.4225352112676
"574","94","4",4,2,4,3,5,5,5,1,1,6,6,3,2,4,1,4,31,28,59,8,11,13.5593220338983,18.6440677966102,47.4576271186441,52.5423728813559
"575","94","5",6,5,2,4,3,4,4,3,5,2,5,3,3,4,3,2,33,28,61,8,9,13.1147540983607,14.7540983606557,45.9016393442623,54.0983606557377
"576","94","6",12,4,5,1,4,4,2,0,3,2,3,1,1,0,0,0,33,12,45,12,7,26.6666666666667,15.5555555555556,26.6666666666667,73.3333333333333
